見る、診る	check - looky look	みます
探す、捜す	look for, search	さがします
遅れる	to be late (for an appointment, etc) kunyomi	おくれます
間に合う、時間に	be in time (for an appointment, etc)	まにあう、じかんに
やる	(to)&nbsp;&nbsp;do not suru or itasu	
（～に）参加する	to attend, participate	（に）さんかする
申し込む	to apply for, enter for	もうしもみます
都合がいい	convenient (concerning time)	つごうがいい
都合が悪い	Inconvenient (concerning time)	つごうがわるい
気分がいい・わるい	Feeling well/ill not guai	きぶんがいい・わるい
新聞社	Newspaper publishing company, newspaper office	しんぶんしゃ
柔道	judo	じゅうどう
運動会	athletic meeting/competition	うんどうかい
場所	Place	ばしょ
ボランティア	volunteer	
～弁	Dialect (i.e. かんさいべん)	～べん
今度	next time, another time	こんど
ずいぶん	pretty, very, awfully	
直接	directly, immediate, firsthand	ちょくせつ
いつでも	any time	
どこでも	anywhere	
だれでも	anyone, any old bod	
何でも	anything	なんでも
こんな～	~like this	
そんな～	~like that (near the listener)	
あんな～	~ like that (far from both the speaker and the listener	
片づく	To be put in order not seiri	かたづきます
ごみ	garbage, trash, dust	
出す	Put out (the trash, etc)	だします
燃える	to be burned (trash, etc)	もえます
置き場	place where something is put	おきば
横	side not kawa or soba	よこ
瓶	Bottle	びん
缶	Can	かん
お湯	hot water	おゆ
ガス	Gas	
～会社	~company	～かいしゃ
連絡する	(to) contact	れんらく　します
困ったなあ	What should I do? I'm in a quandary.	こまったなあ
飼う	To keep a pet, raise an animal	かう
建てる	to build (a house, etc)	たてる
走る	To run, drive (along a road)	はしる
取る	to take (a vacation, etc)	とる
見える	~can be seen	みえる
聞こえる	~can be heard	きこえる
出来る	to be made, be completed, come into existence	できる
開く	set up, open, hold (not okonau)	ひらく
ペット	(a) pet	
鳥	bird	とり
声	voice	こえ
波	wave	なみ
花火	fireworks	はなび
景色	scenery, view	けしき
昼間	daytime	ひるま
昔	old days, long ago, ancient times	むかし
道具	tool, instrument, equipment	どうぐ
自動販売機	vending machine	じどうはんばいき
通信販売	mail order, mail order sales	つうしんはんばい
クリーニング	dry cleaning, laundry	
マンション	condo, apartment	
台所	kitchen	だいどころ
～教室	~class (room)	～きょうしつ
パーティールーム	party room	
～後	after~ (some period of time)	ご
～しか	only ~ (used with negative forms)	
他の~	other ~	ほかの
はっきり	clearly	
ほとんど	almost all (affirmative sentences); hardly, scarcely (in negative sentences)	
本棚	bookshelf	ほんだな
夢	(a) dream	ゆめ
いつか	someday, sometime	
家	house, home	いえ
すばらしい	wonderful, marvelous	
売れる	to be sold, sell	うれる
踊る	to dance	おどる
噛む-かむ	to chew, bite	
選ぶ	to choose, select	えらぶ
違う	to be different	ちがう
通う	to go and from, commute, attend	かよう
メモ(する）	take a memo	
まじめ（な）	serious	
熱心<br>ねっしん（な）	earnest	
優しい	gentle, kind not shinsetsu	やさしい
偉い	great, admirable	えらい
ちょうどいい	proper, just right	
習慣	custom, habit, manners	しゅうかん
経験	experience	けいけん
力	power	ちから
人気	popularity	にんき
形	form, shape	かたち
色	color	いろ
味	taste, flavor	あじ
ガム	chewing gum	
品物	goods not 製品	しなもの
値段	price	ねだん
給料	salary	きゅうりょう
ボーナス	bonus	
番組	program (on television, etc)	ばんぐみ
ドラマ	drama (drama tv series, etc)	
小説	Novel (book)	しょうせつ
小説家	novelist	しょうせつか
管理人	janitor, caretaker, manager, landlady/landlord	かんりにん
息子	(my) son	むすこ
息子さん	(someone else's) son	むすこさん
娘	(my) daughter	むすめ
娘さん	(someone else's) daughter	むすめさん
自分	oneself	じぶん
将来	future	しょうらい
しばらく	a little while	
たいてい	usually, mostly	
それに	in addition	
それで	and so	
開く	a (door, etc) opens	あく
閉まる	a (door, etc) closes, shuts	しまる
点く	A (light, etc) comes on	つく
消える	A (light, etc) goes off, ~disappears	きえる
込む	to get crowded (a road, etc)	こむ
壊れる	to be broken, break (demolish intrans)	こわれる
空く	to get empty (a road, etc)	すく
割れる	(a glass, etc) breaks, smashes	われる
折れる	(a tree, etc) breaks, smashes	おれる
破れる	(the paper, etc) tears, rips	やぶれる
．．が汚れる	(the clothes, etc) get dirty	よごれる
付く	(a pocket, etc) be attached	つく
外れる	(a button, etc) be undone	はずれる
止まります	(an elevator, car, etc) stops	とまります
まちがえる	make a mistake	
落とす	to drop, lose	おとす
ドアが)掛かる	to be locked	かかる
｛お｝皿	plate, dish	さら
｛お｝ちゃわん	rice bowl (bowl for rice)	
コップ	glass, cup	
グラス	glass (the physical material)	
袋	bag	ふくろ
財布	wallet, purse	さいふ
枝	branch, twig	えだ
駅員	(train) station employee	えきいん
この辺	This neighborhood, around here	このへん
～辺	The place around ~ not tokoro	～へん
このくらい	about this size	
お先にどうぞ	After you/go ahead please	おさきにどうぞ
｛ああ｝よかった	Thank goodness; (used to express a feeling of relief)	
(～が)始まる	begin, start	はじまる
．．を続ける	continue trans.	つづける
見つける	to find	みつける
受ける	to take (an examination, etc)	うける
(～に)入学する	To enter (a university, etc)	にゅうがくする
(～を)卒業する	to graduate (from a university, etc)	そつぎょうする
(～に)出席する	To attend (a meeting, etc)	しゅっせきする
休憩する	to take a break, take a rest jukugo	きゅうけいする
連休	Consecutive holidays	れんきゅう
作文	Essay, written composition not bunshou	さくぶん
展覧会	Exhibition (art, etc)	てんらんかい
結婚式	Wedding ceremony	けっこんしき
(お)葬式	Funeral	そうしき
式	Ceremony (often used as a suffix)	しき
本社	Head office, headquarters	ほんしゃ
支店	Branch office	してん
教会	Church	きょうかい
大学院	Graduate school	だいがくいん
動物園	Zoo	どうぶつえん
温泉	Hot Spring, spa	おんせん
お客(さん)	Visitor, guest, customer, client	おきゃく
だれか	somebody, someone	
～の方	place toward ~, in the direction of ~ not 向こう	のほう
ずっと	all the time not itsumo	
残る	To remain, to be left	のこる
月に	per month	つきに
普通の	Ordinary, common, usual	ふつうの
インターネット	(the)&nbsp;&nbsp;Internet	
運動する	To exercise	うんどうする
成功する	To suceed (not goukaku)	せいこうする
(～に)失敗する	To fail (an exam, etc)	しっぱいする
(～に)合格する	To pass (an exam, etc)	ごうかくする
戻る	To return (not kaeru)	もどる
(～が)やむ	(rain, etc) stops	
晴れる	To clear up - get brighter	はれる
曇る	To get cloudy	くもる
(～が)吹く	(wind, etc) blows	ふく
(～が)直る、治る	To be fixed, to be repaired (items)<br>To recover, to get well (sickness)	なおる
(～が)続く	continue intrans	つづく
(～を) 引/弾 ーひく	to catch (a cold, etc)  play piano	
心配(な)	worried, anxious not fuan	しんぱい
十分(な)	enough, sufficient	じゅうぶん
おかしい	strange, funny	
うるさい	noisy	
火傷ーやけど(をする)	burning (to get burned) injury not moeru	
怪我 けが(をする)	injury (to get injured)	
咳 せき(をでる)	cough (to have a cough)	
インフルエンザ	Influenza (the flu)	
空	sky	そら
太陽	sun	たいよう
星	star	ほし
月	moon	つき
風	wind	かぜ
北	north	きた
南	south	みなみ
西	west not seiyou	にし
東	east	ひがし
水道	faucet, tap, water supply	すいどう
エンジン	engine	
チーム	Team	
今夜	This evening	こんや
夕方	late afternoon	ゆうがた
まえ	A time in the past, before	
遅く	late (time)	おそく
こんなに	like this	
そんなに	like that (concerning a matter related to the listener)	
あんなに	Like that (concerning a matter not related to the speaker or the listener), "that much"	
もしかしたら	possibly, perhaps - not tabun	
それはいけませんね	That's too bad	
オリンピック	Olympic Games	
元気	vigor, energy, liveliness	げんき
胃	stomach	い
働きすぎ	working too much	はたらきすぎ
ストレス	Stress	
無理をする	To work more than one's capacity	むりをする
ゆっくりする	to take one's time	
逃げる	to run away	にげる
騒ぐ	to make a noise	さわぐ
諦 (あきら)める	to give up, resign oneself to	
投げる	to throw	なげる
守る	To keep, follow, obey, protect	まもる
上げる	To raise, lift up	あげる
下げる	to lower, pull down	さげる
伝える	To convey (a message, etc)	つたえる
(～に)注意する	to be careful (of cars, etc)	ちゅういする
(～を)外す	To be away (from one's desk, etc)	はずす
だめ(な)	no good, not permitted, not possible	
席	seat	せき
ファイト	fight	
マーク	mark	
ボール	ball	
洗濯機	washing machine	せんたくき
～機	~machine (suffix)	き
規則	regulation, rule	きそく
使用禁止	Do not use	しようきんし
立入り禁止	Keep out	たちいりきんし
入口	entrance not 玄関	いりぐち
出口	exit	でぐち
非常口	emergency exit	ひじょうぐち
無料	free of charge	むりょう
本日休業	closed today	ほんじつきゅうぎょう
営業中	open for business	えいぎょうちゅう
使用中	In use	しようちゅう
～中	~ing (suffix)	ちゅう
どういう～	what kind of ~	
もう .. いません	(not) any longer - (when used with negatives)	
あと～	~left, remaining not nokori	
駐車違反	Parking violation	ちゅうしゃいはん
そりゃあ	well...	
～以内	within ~ (time periods, money, etc)	いない
警察	Police	けいさつ
罰金	Penalty, fine (monetary penalty)	ばっきん
(歯を)磨く	to brush(one's teeth, etc), to polish	(はを)みがく
組み立てる	To assemble, to construct	くみたてる
折る	to bend, fold, break, snap trans.	おる
(～に)気が付く	to notice, to become aware of	きがつく
(砂糖～を)つける	to put something on a food item (such as soy sauce, mayo, etc)	
(～が)見つかる	to be found (intrans)	みつかる
(～を)する	to put on, to wear (for use with accessories, such as a necktie, necklace, or watch)	
質問する	to ask a question	しつもんする
細い	thin (of small diameter)	ほそい
太い	thick, of large diameter not atsui	ふとい
盆踊り	Bon Festival dance	ぼんおどり
スポーツクラブ	sports club	
家具	furniture	かぐ
キー	key	
シートベルト	seatbelt	
説明書	explanatory pamphlet, instruction book	せつめいしょ
図	a figure, drawing	ず
線	a line, lines	せん
矢印	arrow (sign)	やじるし
黒	black (noun)	くろ
白	White (noun)	しろ
赤	red (noun)	あか
青	blue (noun)	あお
紺	dark blue, navy blue (noun)	こん
黄色	yellow (noun)	きいろ
茶色	brown (noun)	ちゃいろ
しょうゆ	Soy sauce	
ソース	sauce (sometimes specifically worcestershire sauce)	
～か～	~ or ~	
ゆうべ	last night	
さっき	a short while ago	
茶道	tea ceremony	さどう
お茶をたてる	to make green tea	おちゃ
先に	first (when expressing order- such as doing something before something else) not mazu or saisho	さきに
載せる	to place on, to load onto	のせる
苦い	bitter	にがい
(はなが)咲く	(flowers, etc) bloom	さく
(～が)変わる	~changes (color, etc) intrans	かわる
困る	to be in trouble, to have a problem	こまる
(～を)付ける	to draw ( a circle, etc), to mark with (a circle, etc)	つける
拾う	to pick up (something from the ground, etc)	ひろう
かかる	to get through (on the phone), to have (a phone call)	
楽	comfortable, easy	らく
正しい	correct, right	ただしい
珍しい	rare, uncommon	めずらしい
方	person (used as a respectful equivalent of 人)	かた
向こう	over there, the other side not sotogawa	むこう
島	island	しま
村	village	むら
港	port, harbor	みなと
近所	neighborhood, vicinity	きんじょ
屋上	rooftop	おくじょう
海外	overseas	かいがい
山登り	mountain climbing	やまのぼり
ハイキング	hiking	
機会	chance, opportunity	きかい
許可	permission	きょか
丸	circle	まる
操作	(business) operation, management, processing	そうさ
方法	method not shikata	ほうほう
設備	equipment, facilities	せつび
紐 (ひも)	string	
蓋 ー ふた	lid, cover, cap	
葉	leaf	は
曲	a piece of music	きょく
楽しみ	pleasure, enjoyment, expectation	たのしみ
もっと	more	
初めに	first -  to start with not saki ni or saisho or mazu	はじめに
これで終わります	We'll finish now	おわります
箱根	Resort area in Kanagawa prefecture	はこね
日光	tourist spot in Tochigi prefecture	にっこう
白馬）	resort area in Nagano prefecture	はくば
アフリカ	Africa	
それなら	in that case	
夜行バス	night bus	やこうバス
旅行者	travel agency	りょこうしゃ
詳しい	detailed	くわしい
スキー場	Ski area, ski resort	スキーじょう
草津	resort area in Gunma prefecture	くさつ
志賀高原	national park in Nagano prefecture	しがこうげん
(～が)届	to be delivered (packages, etc)	とどく
(～に)出る	to participate, appear (in a game, etc) not 参加する	（～に）でる
(～を)打つ	to type (on a word processor, etc)	うつ
貯金する	to save money	ちょきんする
太る	to gain weight, get fat	ふとる
痩せる (やせる	to get slim, lose weight	
(～を)過ぎる	to pass (a time, a place), exceed	すぎる
(～に)慣れる	to get accustomed to, acquainted with, used to	なれる
硬い	hard, tough, solid	かたい
軟らかい 柔らかい	soft, tender	やわらかい
電子～	electronic ~	でんし～
携帯	portable ~	けいたい
工場	factory	こうじょう
健康	health	けんこう
剣道	Kendo (Japanese-style fencing)	けんどう
毎週	every week	まいしゅう
毎月	every month	まいつき
毎年	every year	まいとし・まいねん
やっと	finally not saigo	
かなり	fairly	
必ず	without fail, certainly, by any means not zehi	かならず
絶対に	absolutely (often used with negatives) jukugo	ぜったいに
上手に	well, skillfully	じょうずに
できるだけ	as much as possible	
このごろ	these days	
～ずつ	~(an amount) per (something)	
そのほうが～	That is more ~	
ショパン	Chopin (Polish composer)	
お客様	guest, customer	おきゃくさま
特別（な）	special	とくべつ（な）
～していらっしゃいます	to be doing ~ (a respectful version of している)	
水泳	swimming	すいえい
～とか、～とか	~,~, and so on	
タンゴ	tango (dance)	
チャレンジする	to challenge	
気持ち	feeling, enthusiasm	きもち
褒める	to praise	ほめる
しかる	to scold	
誘う	to invite, to ask someone to join (onyomi) not 招待	さそう
起こす	to wake (someone) up	おこす
招待する	to invite jukugo	しょうたいする
頼む	to ask, request	たのむ
注意する	to warn, advise	ちゅういする
とる	to rob, steal not nusumu	
踏む	to step on (someone's foot, etc)	ふむ
壊す	to break, destroy demolish trans.	こわす
汚す	to make ~ dirty	よごす
行う	to hold, carry out, practice	おこなう
輸出する	to export	ゆしゅつする
輸入する	to import	ゆにゅうする
翻訳する	to translate	ほんやくする
発明する	to invent	はつめいする
発見する	to discover	はっけんする
設計する	to design, plan not 計画	せっけいする
米	rice	こめ
麦	barley, wheat	むぎ
石油	(mineral) oil	せきゆ
原料	raw material not 材料	げんりょう
デート	date	
泥棒	thief, robber	どろぼう
警官	policeman	けいかん
建築家	architect	けんちくか
科学者	scientist	かがくしゃ
漫画	cartoon, comic	まんが
世界中	all over the world	せかいじゅう
～中	all over ~	じゅう
～によって	by~	
よかったですね	that's lucky, isn't it?	
ドミニカ	Dominica	
ライト兄弟	Wright brothers	ライトきょうだい
源氏物語	The Tale of Genji	げんじものがたり
江戸時代	Edo period (1603-1868)	えどじだい
埋め立てる	to reclaim	うめたてる
技術	technology, technique	ぎじゅつ
土地	land	とち
騒音	noise jukugo	そうおん
利用する	use (to use) not tsukau	りよう
アクセス	access	
育てる	to breed, raise, bring up - not kau	そだてる
運ぶ	to carry, transport	はこぶ
亡くなる	to pass away	なくなる
入院する	to enter a hospital	にゅういんする
退院する	to leave a hospital	たいいんする
入れる	to turn on (a device, switch) not tsukeru	いれる
切る	to turn off (a device, power switch) not kesu	きる
掛ける	to lock (a door, etc)	かける
気持ちがいい	pleasant, agreeable (mood)	きもち
気持ちが悪い	unpleasant, disgusting (mood)	きもちがわるい
大きな～	large ~	おおきな
小さな～	small ~	ちいさな
小学校	elementary school	しょうがっこう
中学校	junior high school (middle school)	ちゅうがっこう
駅前	the area in front of the station	えきまえ
海岸	seaside, seashore	かいがん
嘘	lie, fib	うそ
書類	document, papers, paperwork	しょるい
電源	power switch	でんげん
～製	made in ~ (country name)	せい
(あ、)いけない	oops!, "oh no!" (used when one has made a mistake)	
お先に	excuse me for ~ before (used when performing an action before someone and acknowledging that it could potentially be rude to do so- often used　together with しつれします)	おさきに
回覧	circular, sending around	かいらん
研究室	study room, professor's office, research office, laboratory	けんきゅうしつ
きちんと	neatly, tidily not ちゃんと	
整理する	to put things in order, tidy up not katazukeru	せいり
～という本	the named ~	ほん
～冊	the counter suffix for books	さつ
判子	seal stamp	はんこ
{～を}押す	to affix (a seal etc), push, press	おす
答える	to answer (a question)	こたえる
(～が)倒れる	fall down, collapse (a building, etc) not 壊れる	たおれる
(～が)焼ける	burn down (a house), bake, roast, grill intrans.	やける
(～を)通る	to pass (along a street, etc)	とおる
死ぬ	to die	しぬ
びっくりする	to be surprised	
がっかりする	to be disappointed	
安心する	to be relieved	あんしんする
遅刻する	to be late, to come late jukugo	ちこくする
早退する	to leave earlier than usual (work, school, etc)	そうたいする
けんかする	quarrel, fight	
離婚する	to divorce	りこんする
複雑(な)	complicated, complex	ふくざつ
邪魔(な)	obstructive, in the way, intereference	じゃま
汚い	dirty	きたない
うれしい	glad, happy	
悲しい	sad	かなしい
恥ずかしい	embarrased, ashamed	はずかしい
地震	earthquake	じしん
台風	typhoon	たいふう
火事	fire	かじ
事故	accident	じこ
(お)見合い	interview with prospective marriage partner	みあい
電話代	telephone charge	でんわだい
～代	~charge/fee not ryoukin e.g. 電話	だい
フロント	front desk, reception desk	
～号室	room number ~	ごうしつ
汗	sweat, perspiration	あせ
タオル	towel	
せっけん	soap	
大勢	a great number of people	おおぜい
お疲れ様でした	thank you for all the hard work (usually used with people on equal or subordinate social level)	おつかれさまでした
伺う	to go, come (humble equivalent of いく）	うかがう
途中で	on the way, in the middle of	とちゅう
トラック	truck, lorry	
ぶつかる	to bump, collide with	
並ぶ	to line up, stand in a queue intrans	ならぶ
数える	to count	かぞえる
量る・測る	to measure, weigh	はかる
確かめる	to confirm, make sure	たしかめる
(～が)合う	~ fits (clothes size, etc)	あう
出発する	to depart	しゅっぱつする
到着する	to arrive jukugo	とうちゃく
酔う	to get drunk, intoxicated	よう
危険(な)	dangerous jukugo	きけん
必要(な)	necessary, required	ひつよう
宇宙	space, universe	うちゅう
地球	earth	ちきゅう
忘年会	year-end party	ぼうねんかい
新年会	New Year's party	しんねんかい
二次会	second party (afterparty)	にじかい
マラソン	marathon, race	
コンテスト	contest	
表	face, front	おもて
裏	back (side)	うら
返事	reply not kotae	へんじ
申し込み	application	もうしこみ
本当	truth, fact not 実 or 実際	ほんとう
まちがい	mistake	
傷	defect, wound, scratch	きず
ズボン	trousers	
長さ	length	ながさ
重さ	weight	おもさ
高さ	height	たかさ
大きさ	size, scale	おおきさ
～便	flight, flight number	びん
～号	train number, typhoon number, etc	ごう
～個	counter for small objects	こ
～本	counter for long objects	ほん
～杯	glass or cup of something (counter for full cups, glasses)	はい
～キロ	~kilograms or kilometers	
～グラム	~grams	
～センチ	~centimeters	
～ミリ	millimeters	
～以上	not less than ~, not over ~	いじょう
～以下	not more than ~, under ~	いか
さあ	well, let me see (when unsure of something)	
ゴッホ	Vincent van Gogh	
雪祭り	snow festival (in Sapporo)	ゆきまつり
どうでしょうか？	How is ~ (politer than どうですか)	
クラス	class	
テスト	test, examination	
成績	performance, score, grade	せいせき
ところで	by the way...	
いらっしゃいます	to go/come (respectful version of くる・いく)	
様子	situation, condition, appearance not guai or kibun or kakko or joutai	ようす
いただく	Receive (Humble equivalent of もらいます)	
くださる　（-&gt;くださいます）	to give (respectful equivalent of くれる)	
やる	to give (to a younger person, subordinate, or plant/animal)	
呼ぶ	to invite, call	
取り替える	to exchange (an item)	とりかえる
親切(にする)	to be kind to ~	しんせつ
かわいい	lovely/cute	
お祝い	celebration, gift (~をする - to celebrate)	おいわい
お年玉	money given (usually to children) as a new year's gift	おとしだま
（お）見舞い	expression of sympathy, consolatory gift to a sick person	みまい
興味	interest	きょうみ
情報	information, news, gossip, intelligence not annai	じょうほう
文法	grammar	ぶんぽう
発音	pronounciation	はつおん
猿	monkey	さる
餌ーえさ	feed, bait	
おもちゃ	toy	
絵本	picture book	えほん
絵はがき	picture postcard	えはがき
ドライバー	screwdriver	
ハンカチ	handkerchief	
靴下	socks, stockings	くつした
手袋	gloves	てぶくろ
指輪	ring	ゆびわ
バッグ	bag	
祖父	(my) grandfather	そふ
祖母	(my) grandmother	そぼ
孫	grandchild	まご
おじ	(my) uncle	
おじさん	(someone else's) uncle	
おば	(my) aunt	
おばさん	(someone else's) aunt	
おととし	the year before last	
はあ	yes, I see	
申し訳ありません	I'm sorry/excuse me (more formal)	もうしわけありません
預かる	keep, receive something (of someone else's) in trust	あずかる
先日	the other day jukugo	せんじつ
助かる	Be of help not tetsudau or yakunitatsu or sewa suru	たすかる
～が　増える	~ increases	ふえる
～が　減る	~ decreases	へる
～が　上がる	~ rises (a value)	あがる
～が　下がる	~ falls (a value)	さがる
～が　切れる	break, snap (a string, etc) intrans not oreru	きれる
～が　とれる	come off (a button, etc) not 外れる	
～が　落ちる	fall down	おちる
～が　なくなります	run out, be lost (gasoline, etc)	
丈夫(な)	strong, healthy not kenkou	じょうぶ
変(な)	strange, peculiar not okashi	へん
幸せ(な)	happy not ureshi	しあわせ
うまい	tasty, good at	
つまらない	boring, uninteresting	
ガソリン	petrol, gasoline	
火	fire	ひ
暖房	heating	だんぼう
冷房	air conditioning	れいぼう
センス	taste, sense (in clothing, etc)	
今にも	at any moment (for describing a situation just before it changes)	いまにも
わあ	oh!, wow!	
会員	member	かいいん
適当(な)	suitable, proper	てきとう
年齢	age	ねんれい
収入	income not kyuuryo	しゅうにゅう
ぴったり	exactly, just right not choudo	
そのうえ	in addition to that, moreover	
～といいます	(one's name is ~)	
泣く	to cry	なく
笑う	to laugh, smile	わらう
～が　乾く	~dries (intr. of 'to dry')	かわく
～が　ぬれる	~gets wet	
滑る	slip (on ice, etc)	すべる
～が　起こる	~ happens (an accident, etc)	おこる
調節(する)	adjust	ちょうせつ
安全	safe	あんぜん
丁寧	polite, courteous, careful	ていねい
細かい	small, fine (change, particles, etc)	こまかい
濃い	strong (taste), dark (color)	こい
薄い	weak (taste), light (color)	うすい
空気	air	くうき
涙	tears (as in teardrop)	なみだ
和食	Japanese style food	わしょく
洋食	western style food	ようしょく
おかず	side dish	
量	quantity	りょう
～倍	~times (multiples of items, values, etc) not me, kai, do or ban	ばい
半分	half (an amount, etc)	はんぶん
シングル	Single (bed) room (hotel, bedroom)	
ツイン	Twin (bed) room (hotel, bedroom, etc)	
たんす	chest of drawers, dresser not 引き出し	
洗濯物	washing, laundry (items being laundered)	せんたくもの
理由	reason	りゆう
どう　なさいますか	What can I do for you?	
カット	haircut	
シャンプー	Shampoo	
どういうふうになさいますか	how would you like it done?	
ショート	short	
～みたいにしてください	do you like ~ sonkeigo	
これでよろしいでしょうか	Would this be all right?	
(どうも)おつかれさまでした	thank you for being patient	
謝る	to apologize	あやまる
～にあう	to encounter (an accident, etc)	
信じる	to believe, trust	しんじる
用意する	to prepare not junbi or shitaku	ようい
キャンセルする	to cancel (an event, etc)	
うまく　いく	to go well	
保証書	Guarantee, warranty	ほしょうしょ
領収書	receipt (from a grocery store, etc)	りょうしゅうしょ
贈り物	gift, present	おくりもの
間違い電話	wrong phone number	まちがいでんわ
キャンプ	camp	
係	person in charge	かかり
中止	calling off, suspension, cancelling	ちゅうし
点	point, score	てん
レバー	lever	
札	note, bill (paper money)	さつ
ちゃんと	regularly, properly	
急に	suddenly	きゅうに
楽しみにしている	be looking forward to, be expecting	たのしみ
以上です	that's all	いじょう
係員	person in charge, attendant long form	かかりいん
コース	course (of a race, etc)	
スタート	start (place or line of a race, etc)	
～位	~th ranking	い
優勝する	to win the championship	ゆうしょう
包む	to wrap (in plastic, foil, etc)	つつむ
沸かす	to boil trans.	わかす
混ぜる	to mix	まぜる
計算する	to calculate	けいさん
厚	thick (in size)	あつい
薄い	Thin (in size) not 細い, diluted, weak	うすい
弁護士	lawyer, attorney	べんごし
音楽家	musician	おんがくか
子供たち	children	こどもたち
二人	couple (of people)	ふたり
教育	education	きょういく
歴史	history	れきし
文化	culture	ぶんか
社会	society	しゃかい
法律	law	ほうりつ
戦争	war	せんそう
平和	peace	へいわ
目的	purpose	もくてき
論文	thesis, academic paper	ろんぶん
関係	relation, connection	かんけい
ミキサー	mixer, blender	
薬缶ーやかん	kettle (for hot water)	
栓抜き	cap opener (for beer bottles, etc)	せんぬき
缶切り	can opener	かんきり
缶詰	canned food	かんづめ
風呂敷ーふろしき	wrapping cloth used to carry things	
算盤ーそろばん	abacus	
体温計	thermometer (for measuring body temperature)	たいおんけい
材料	Material, ingredient	ざいりょう
石	stone	いし
ピラミッド	pyramid	
データ	data	
ファイル	file	
ある～	a certain ~, one ~	
一生懸命	with all one's effort	いっしょうけんめい
なぜ	why	
国連	United Nations	こくれん
焼く	to bake, grill, roast	やく
渡す	to hand over	わたす
帰って来る	to come back not just kaeru	かえってくる
出る	to leave, depart (intr.) not suppatsu	でる
留守	absence	るす
宅配便	delivery service	たくはいびん
原因	cause	げんいん
注射	injection (shot, as in vaccine, etc)	ちゅうしゃ
パンフレット	pamphlet	
ステレオ	stereo	
こちら	my place, side, this way	
～の所	the <b>place </b>around ~ not hen or atari	ところ
ちょうど	just, exactly not pittari	
たった今	just now (used with past tense and indicates completion)	たったいま
今いいですか。	May I bother you now?	いまいいですか。
ガスサービスセンター	gas service center	
ガスレンジ	gas range, gas cooker	
具合	condition (similar to ちょうし) not yousu	ぐあい
どちらさまでしょうか	Who is this, please?	
向かう	to head for, in the direction of	むかう
おまたせしました	Sorry to have kept you waiting not tsukaresama	
集まる	to gather (intrs)	あつまる
分かれる	part, separate (intrs.)	わかれる
長生きする	to live long	ながいきする
音・声・味・においがする	sound/voice is heard, a smell is smelled (?), a taste is tasted	おと・こえ・あじ
さす	to put up (an umbrella, etc)	
酷い	terrible, severe, cruel	ひどい
怖い	frightening, horrible	こわい
天気予報	weather forecast	てんきよほう
発表	announcement, presentation x	はっぴょう
実験	experiment	じっけん
人口	population (of a country, etc)	じんこう
におい	scent, odor, smell	
科学	science	かがく
医学	medicine, medical science	いがく
文学	literature	ぶんがく
パトカー	(police) patrol car katakana	
救急車	ambulance	きゅうきゅうしゃ
賛成	approval, agreement not shouchi or kyoka	さんせい
反対	objection, opposition	はんたい
男性	male, man jukugo	だんせい
女性	female, woman	じょせい
どうも	it appears to be that... (used when making a tentative judgement)	
～によると	according to ~	
恋人	boyfriend, girlfriend	こいびと
婚約する	to get engaged (to be married)	こんやくする
相手	the other person (usually in a conversation or some other social engagement)	あいて
知り合う	to get acquainted with	しりあう
降ろす／下ろす	to put down, lower (an object) not sageru	おろす
届ける	to deliver, report not 伝える	とどける
世話をする	to take care of ~	せわ
嫌(な)	unwilling, reluctant	いやな
厳しい	strict, tough, hard	きびしい
塾	cram school	じゅく
スケジュール	schedule	
生徒	pupil (as in student)	せいと
者	person (when referring to one's relatives or subordinated)	もの
入管	immigration bureau	にゅうかん
再入国ビサ	re-entry visa	さいにゅうこく
自由に	freely, "at your leisure", "feel free to"	じゆう
～間	for ~ (some duration of time)	かん
いいことですね	That's good not yokatta	
お忙しいですか	Are you busy? (used when talking to someone socially senior, or older)	おいそがしいですか
久しぶり	after a long time	ひさしぶり
営業	business, sales (seen often as 営業中)	えいぎょう
それまでに	by that time ~	
かまいません	it's alright/"it doesn't matter"	
楽しみに	enjoy oneself	たのしみに
～に勤める	to work at ~ (to be employed at)	つとめる
休む	go to bed, sleep (usually used instead of ねる in けいご)	やすむ
（～に）掛ける	to sit on (used instead of すわる in けいご)	かける
過ごす	to spend or pass (usually time)	すごす
寄る	to stop at ~, to drop by ~ (implies that there's an overarching primary destination)	よる
いらっしゃる	そんけいご equivalent for to be, to go, to come	
召し上がる	そんけいご equivalent of to eat, to drink	めしあがる
おっしゃる	そんけいご equivalent for to say	
なさいます	そんけいご equivalent for "to do"	
ご覧になります	そんけいご equivalent for "to see", "to look at"	ごらんになります
ご存じです	そんけいご equivalent of "to know" - しっている	ごぞんじです
あいさつ	greeting, address	
灰皿	ashtray	はいざら
旅館	Japanese-style inn or hotel	りょかん
会場	meeting place	かいじょう
バス停	bus stop	バスてい
貿易	trade (as in economics/business - a trading company, etc)	ぼうえき
帰りに	on the way back	かえりに
たまに	once in a while	
ちっとも	not at all (used with negative forms) not zettai	
遠慮なく	without reserve or hesitation	えんりょなく
～年～組	class ~ of ~th grade	ねん・ぐみ
では	well then (polite equivalent of じゃ)	
ねつを出す	to run a fever	だす
よろしくつたえください	give my best regards, "please say hello"	
失礼いたします	good bye (humble)	しつれい
参る	けんじょうご equivalent of to go, to come	まいる
おる	けんじょうご equivalent for 'to be' iru	おります
いただく	けんじょうご equivalent for 'to eat', 'to drink', and 'to receive'	
申す	けんじょうご equivalent for 'to say'	もうす
いたす	けんじょうご equivalent for 'to do'	
拝見する	けんじょうご equivalent of 'to see'	はいけんする
存じる	けんじょうご equivalent of 'to know' - しります	ぞんじます
伺う	けんじょうご for 'to ask', 'to hear', and 'to visit' - it acts as a humble equivalent of '行く' when the destination is a person or the end goal is to meet with a person or group	うかがう
お目にかかる	けんじょうご equivalent of 'to meet'	おめにかかる
ござる	けんじょうご equivalent for aru	ございます
～でございます	けんじょうご equivalent of ’です' to be	
私	けんじょうご equivalent of the personal pronoun 'I'	わたくし
ガイド	guide (tour guide, etc)	
お宅	honorific term for someone's house, residence	おたく
郊外	suburb	こうがい
アルバム	album (photos)	
再来週	the week after next	さらいしゅう
再来月	The month after next	さらいげつ
再来年	The year after next	さらいねん
半年	half a year	はんとし
最初に	first of all	さいしょに
最後に	lastly	さいごに
ただ今	right now 	ただいま
緊張する	to become tense, strained	きんちょう
放送する	to broadcast	ほうそう
～に　撮る	to record (on video)	とる
賞金	prize money	しょうきん
自然	nature	しぜん
きりん	giraffe	
象	elephant	ぞう
頃ーころ	times, days	
～が叶う ーかなう	to be realized (dreams, goals, etc)	
ひとことよろしいですか	may I say one word?	
協力する	to cooperate	きょうりょく
心から	from my heart	こころから
感謝する	to be grateful, to be thankful	かんしゃ
あ<br /><br />int	Ah
ああ<br><br>int	like that,that way
挨拶ーあいさつ・する<br /><br />n,vs	greeting, to greet
あいだ<br>間<br>n	space,interval
あう<br>合う<br>u-v	to fit,to match
あかちゃん<br><br>n	baby,infant
あがる<br>上がる<br>u-v	to rise,to go up
あかんぼう<br>赤ん坊<br>n	baby
あく<br>空く<br>u-v,vi	to open,to become empty not suku
アクセサリー<br><br>n	accessory
あげる<br><br>ru-v	to give
あさい<br>浅い<br>adj	shallow,superficial
あじ<br>味<br>adj-na,n	flavor,taste
アジア<br><br>n	Asia
あす<br>明日<br>n-t	tomorrow
あそび<br>遊び<br>n,n-suf	play
あつまる<br>集る<br>u-v	to gather,to collect
あつめる<br>集める<br>ru-v,vt	to collect,to assemble
アナウンサー<br><br>n	announcer
アフリカ<br><br>n	Africa
アメリカ<br><br>n	America
あやまる<br>謝る<br>u-v	to apologize
アルコール<br><br>n	alcohol
アルバイト<br><br>n	part-time job
あんしん<br>安心<br>adj-na,n, vs	peace of mind,relief
あんぜん<br>安全<br>adj-na,n	safety,security
あんな<br><br>adj-na,adj-pn	such,like that
あんない・する<br>案内<br>n,vs	information,guidance, show around not jouhou
いか<br>以下<br>n	less than,below
いがい<br>以外<br>n	with the exception of,excepting
いがく<br>医学<br>n	medical science
いきる<br>生きる<br>ru-v	to live,to exist
いくら～ても<br><br>	however much one may ～
いけん<br>意見<br>n	opinion,view
いし<br>石<br>n	stone
苛める ーいじめる<br><br>ru-v	to tease,to torment
いじょう<br>以上<br>n-adv,n-t	more than,this is all
いそぐ<br>急ぐ<br>u-v	to hurry,to rush
いたす<br>致す<br>u-v	(hum) to do
いただく<br><br>u-v	to receive,to take food or drink (hum)
いちど<br>一度<br>n-adv	once,one time
いっしょうけんめい<br>一生懸命<br>adj-na,n-adv,n	as well as one can,with utmost effort not dekiru dake or narubeku
一杯ーいっぱい<br><br>adv	full (cup),to the utmost
いと<br>糸<br>n,n-suf	thread
いない<br>以内<br>n,n-suf	within,inside of not 内側
いなか<br>田舎<br>giku n	rural,countryside
いのる<br>祈る<br>u-v,vi	to pray,to wish
いらっしゃる<br><br>aru-v	(hon) to be,to come,to go
～いん<br>～員<br>n-suf	member of ～
うえる<br>植える<br>ru-v	to plant,to grow
伺う (うかがう<br><br>u-v,vi,vt	to visit, pay respects
うけつけ<br>受付<br>n	reception (desk),information 
うける<br>受ける<br>ru-v	to take (lesson, test),to undergo
うごく<br>動く<br>u-v,vi	to move
うそ<br><br>n	lie
うち<br><br>n	within not inai
うつ<br>打つ<br>u-v	to hit,to strike
うつくしい<br>美しい<br>adj	beautiful,lovely
うつす<br>写す<br>u-v	copy,to photograph,to film
うつる<br>移る<br>u-v	to move (house),to transfer (department)
うで<br>腕<br>n	arm
旨いーうまい<br><br>adj	delicious not oishii
うら<br>裏<br>n	reverse side,wrong side,back
うりば<br>売り場<br>adj-no,n	place where things are sold
嬉しいーうれしい<br><br>adj	happy,glad not shiawase
うん<br><br>n	yes (informal),alright
うんてんしゅ<br>運転手<br>n	driver,chauffeur
うんてん・する<br>運転<br>n,vs	driving
うんどう・する<br>運動<br>n,vs	exercise (fitness)
エスカレーター<br><br>n	escalator
えだ<br>枝<br>n	branch,twig
えらぶ<br>選ぶ<br>v5b	to choose,to select
えんりょ・する<br>遠慮<br>adj-na,n,vs	restraint,reserve
おいでになる<br><br>u-v	(hon)to be iru not irasharu
おいわい<br>お祝い<br>n	congratulation,celebration
オートバイ<br><br>n	motorcycle (lit: auto-bi(ke))
オーバー<br><br>adj-na,n,vs	overcoat
おかげ<br><br>n	thanks or owing to
おかしい<br><br>adj	strange,funny
～おきに<br><br>	after every ～
おく<br>億<br>num	100,000,000,hundred million
おくじょう<br>屋上<br>n	rooftop
おくりもの<br>贈り物<br>n	present,gift
おくる<br>送る<br>u-v	to send (a thing),to dispatch
おくれる<br>遅れる<br>ru-v	to be late,to be delayed
おこさん<br>お子さん<br>n	(someone else's) child
おこす<br>起こす<br>u-v	to wake someone
おこなう<br>行う<br>u-v	to perform, to do, to carry out
おこる<br>怒る<br>u-v	to get angry,to be angry
おしいれ<br>押し入れ<br>n	closet
おじょうさん<br>お嬢さん<br>n	(1) (hon) daughter,(2) young lady
おたく<br>お宅<br>n	(pol) your house,your home
おちる<br>落ちる<br>ru-v	to fall,to drop intrans
おっしゃる<br><br>aru-v	(hon) to say,to speak
おっと<br>夫<br>n	husband not 主人
お釣りーおつり<br><br>n	change (money),balance, fishing
おと<br>音<br>n,n-suf	sound,note
おとす<br>落す<br>u-v	to drop,to lose not nakusu or ushinau
おどり<br>踊り<br>n	dance n.
おどる<br>踊る<br>u-v	to dance
おどろく<br>驚く<br>u-v	to be surprised,to be astonished not bikkuri
おまつり<br>お祭り<br>	festival
おみまい<br>お見舞い<br>n	calling on someone who is ill,enquiry
おみやげ<br>お土産<br>n	souvenir
おもいだす<br>思い出す<br>u-v	to recall,to remember not 思い浮かべる
おもう<br>思う<br>u-v	to think,to feel
おもちゃ<br><br>n	toy
おもて<br>表<br>n,n-suf	the front,surface,exterior
おや<br>親<br>n	parents not ryoushin
おりる<br>下りる<br>ru-v	to descend a mountain,to (descend) go down stairs
おる<br><br>u-v	to be (humble version of いる)
おる<br>折る<br>u-v	to break,to fold,to pick a flower
おれい<br>お礼<br>n	thanking,expression of gratitude not kansha
おれる<br>折れる<br>intrans	to break,to be folded,to give in,to turn (a corner) not magaru
おわり<br>終わり<br>n	the end
～おわる<br><br>suf	end of ～
～か<br>～家<br>	professional ～
カーテン<br><br>n	curtain
～かい<br>～会<br>	～ meeting
かいがん<br>海岸<br>n	coast,beach
かいぎ<br>会議<br>n	meeting,conference
かいぎしつ<br>会議室<br>n	conference room
かいじょう<br>会場<br>n	assembly hall,meeting place,the grounds
かいわ<br>会話<br>n	conversation
かえり<br>帰り<br>n	return,coming back n.
かえる<br>変える<br>ru-v,vt	to change,to alter,to vary trans.
かがく<br>科学<br>n	science
かがみ<br>鏡<br>n	mirror
～がくぶ<br>～学部<br>	department of a university
かける<br>掛ける<br>	to hang,to put on (eg wall)
かける<br><br>	to sit down
かざる<br>飾る<br>u-v	to decorate,to ornament,to adorn
かじ<br>火事<br>n	fire, conflagration
ガス<br><br>n	gas
ガソリン<br><br>n	gasoline,petrol
ガソリンスタンド<br><br>n	gasoline stand,gas station,petrol station
かた<br>方<br>n-suf	way of doing
かたい<br>堅/硬/固い<br>adj	solid,hard,firm
かたち<br>形<br>n	shape
かたづける<br>片付ける<br>ru-v	to tidy up,to put in order,to put away not seiri
かちょう<br>課長<br>n	section manager
かつ<br>勝つ<br>u-v	to win,to gain victory
かっこう<br><br>no--adj, na-adj	appearance,manner
かない<br>家内<br>n	my wife, inside the home
かなしい<br>悲しい<br>adj	sad,sorrowful
かならず<br>必ず<br>adv	certainly,necessarily,invariably
かねもち/おかねもち<br>お・金持ち<br>n	rich man
かのじょ<br>彼女<br>n	she,girl-friend
かべ<br>壁<br>n	wall
構うーかまう<br><br>u-v	to mind,to care about
かみ<br>髪<br>n	hair not ke
かむ<br>噛む<br>u-v	to bite,to chew
かよう<br>通う<br>u-v	(1) to go back and forth,(2) to commute
ガラス<br><br>n	glass,pane
かれ<br>彼<br>n	he,boyfriend
かれら<br>彼ら<br>n	they (usually male)
かわく<br>乾く<br>u-v,vi	to get dry
かわり<br>代わり<br>n	substitute,alternate
かわる<br>変わる<br>u-v,vi	to change,to be transformed,to vary
かんがえる<br>考える<br>ru-v	to consider
かんけい<br>関係<br>n,vs	relation,connection
かんごふ<br>看護婦<br>n	(female) nurse
かんたん<br>簡単<br>adj-na,n	simple
がんばる<br>頑張る<br>u-v	to try one's best,to persist
き<br>気<br>n	spirit,mood
きかい<br>機会<br>n	chance,opportunity
きけん<br>危険<br>adj-na,n	danger,peril,hazard
きこえる<br>聞こえる<br>ru-v	to be heard,to be audible
きしゃ<br>汽車<br>n	train (steam)
ぎじゅつ<br>技術<br>n	art,technique,technology,skill
きせつ<br>季節<br>n	season
きそく<br>規則<br>n	rule,regulations
きっと<br><br>adv,n	surely,definitely not zehi or tashikani
きぬ<br>絹<br>n	silk
きびしい<br>厳しい<br>adj	strict
きぶん<br>気分<br>n	feeling,mood not kimochi
きまる<br>決る<br>u-v	to be decided,to be settled
きみ<br>君<br>n,suf	You (masculine term for female)
きめる<br>決める<br>ru-v	to decide
きもち<br>気持ち<br>n	feeling,sensation,mood
きもの<br>着物<br>n	kimono
きゃく<br>客<br>n	guest,customer
きゅう<br>急<br>adj-na,n	(1) urgent,sudden,(2) steep
きゅうこう<br>急行<br>n	express (eg train that bypasses stations) not quite a 特急
きょういく<br>教育<br>adj-no,n,vs	training,education
きょうかい<br>教会<br>n	church
きょうそう<br>競争<br>n,vs	competition,contest - not shiai
きょうみ<br>興味<br>n	interest (in something)
きんじょ<br>近所<br>n	neighbourhood
～く<br>～区<br>n	district ～
ぐあい<br>具合<br>n	condition,state,health
くうき<br>空気<br>n	air,atmosphere
くうこう<br>空港<br>n	airport
くさ<br>草<br>n	grass
くださる<br><br>aru-v	(hon) to give,to confer
くび<br>首<br>n	neck
くも<br>雲<br>n	cloud
くらべる<br>比べる<br>ru-v	to compare
くれる<br><br>ru-v	to give to me,to do for not kudasaru
くれる<br>暮れる<br>ru-v	to get dark,to come to an end
～くん<br>～君<br>n-suf	Mr (junior) ～,master ～
け<br>毛<br>n	hair not kami
けいかく・する<br>計画<br>n,vs	plan,project,schedule not sekkei
けいけん・する<br>経験<br>n,vs	experience
けいざい<br>経済<br>n	economics,finance,economy
けいさつ<br>警察<br>n	police
怪我 (けが)・する<br><br>n,vs	injury (to animate object),hurt
ケーキ<br><br>n	cake
けしき<br>景色<br>n	scenery,scene,landscape
けしゴム<br>消しゴム<br>n	eraser
げしゅく<br>下宿<br>n,vs	boarding,lodging,boarding house
けっして<br>決して<br>adv	never
けれど/けれども<br><br>conj	but,however
～けん<br>～軒<br>	counter for houses
げんいん<br>原因<br>n	cause,origin,source
喧嘩ーけんか・する<br><br>n	quarrel
げんかん<br>玄関<br>n	entrance way (in Japanese house)
けんきゅう<br>研究<br>n,vs	study,research,investigation
けんきゅうしつ<br>研究室<br>n	study room,laboratory
けんぶつ<br>見物<br>n	a sight,an attraction
こ<br>子<br>n	child
ご～<br>御～<br>prefix	honourable ～
こう<br><br>adv,int-n	like this,this way
こうがい<br>郊外<br>n	suburb,outskirts
こうぎ<br>講義<br>n,vs	lecture
こうぎょう<br>工業<br>n	(manufacturing) industry not seisan
こうこう/こうとうがっこう<br>高校/高等学校<br>n	high school/senior high school
こうこうせい<br>高校生<br>n	high school student
こうじょう<br>工場<br>n	factory
こうちょう<br>校長<br>n	principal,headmaster
こうつう<br>交通<br>n	traffic,transportation
こうどう<br>講堂<br>n	auditorium
こうむいん<br>公務員<br>n	government worker,public servant
こくさい<br>国際<br>n	international
こころ<br>心<br>n	core,heart
～ございます<br><br>expr	to be (polite),to exist
ごしゅじん<br>ご主人<br>n	your husband,her husband
こしょう・する<br>故障<br>n,vs	break-down
ごぞんじ<br>ご存じ<br>n	knowing,acquaintance sonkeigo
こたえ<br>答<br>n	answer,response not henji
ごちそう<br><br>n,vs	feast,treating (someone)
こっち<br><br>n	(1) this person,(2) this direction,(3) this side,(4) thereafter
こと<br><br>n	thing,matter,fact
ことり<br>小鳥<br>n	small bird
このあいだ<br><br>n-adv	the other day,recently not senjitsu
このごろ<br><br>	these days,nowadays
こまかい<br>細かい<br>adj	(1) small,(2) fine,minute not hosoi
ごみ<br><br>n	rubbish,trash,garbage
こむ<br>込む<br>u-v	to be crowded
こめ<br>米<br>n	uncooked rice
これから<br><br>n-t	after this
こわい<br>怖い<br>adj	scary,frightening not 恐ろしい
こわす<br>壊す<br>u-v,vt	to break,to break down, demolish trans.
こわれる<br>壊れる<br>ru-v,vi	to be broken,to break, be demolished
コンサート<br><br>n	concert
こんど<br>今度<br>n-adv,n-t	now,next time
コンピュータ/コンピューター<br><br>n	computer
こんや<br>今夜<br>n-adv,n-t	this evening,tonight - not ban
さいきん<br>最近<br>adj-no,n-adv,n-t	latest,most recent,nowadays not konogoro
さいご<br>最後<br>n	lastly,end,conclusion not owari
さいしょ<br>最初<br>adj-no,n-adv,n-t	beginning,first, at first not hajime
さか<br>坂<br>n	slope,hill
さがす<br>探す<br>u-v	to search,to seek,to look for
さがる<br>下る<br>u-v	to get down,to descend
さかん<br>盛ん<br>adj-na,n	popularity,prosperous
さげる<br>下げる<br>ru-v	to hang,to lower,to move back trans. not orosu
さしあげる<br>差し上げる<br>ru-v	(humble) to give,to offer
さっき<br><br>n	some time ago
さびしい<br>寂しい<br>adj	lonely,lonesome
～さま<br>～様<br>n-suf	Mr or Mrs ～
さらいげつ<br>さ来月<br>	the month after next
さらいしゅう<br>さ来週<br>n-adv,n-t	the week after next
サラダ<br><br>n	salad
さわぐ<br>騒ぐ<br>u-v	to make noise,to clamor,to be excited
さわる<br>触る<br>u-v	to touch,to feel
さんぎょう<br>産業<br>n	industry
サンダル<br><br>n	sandal
サンドイッチ<br><br>n	sandwich
ざんねん<br>残念<br>adj-na,n	bad luck,disappointment not 不幸
し<br>市<br>n	city
じ<br>字<br>n	character,hand-writing
しあい<br>試合<br>n	match,game,contest not kyuusou
しかた<br>仕方<br>n	way,method not houhou
叱る ーしかる<br><br>u-v	to scold
～しき<br>～式<br>	ceremony
しけん<br>試験<br>n,vs	examination,test,study
じこ<br>事故<br>n	accident
じしん<br>地震<br>n	earthquake
じだい<br>時代<br>n-t	period,epoch,era
したぎ<br>下着<br>n	underwear
したく・する<br>支度<br>n,vs	preparation not junbi or youi
しっかり<br><br>adj-na,adv,n	firmly,tightly,steady
しっぱい<br>失敗<br>adj-no,n,vs	failure,mistake,blunder not 誤り or 間違え
しつれい<br>失礼<br>adj-na,int,n,vs,exp	(1) discourtesy,impoliteness,(2) Excuse me,Goodbye
じてん<br>辞典<br>n	dictionary not jibiki or jisho
しなもの<br>品物<br>n	goods
しばらく<br><br>adv,int	little while
しま<br>島<br>n	island
（～て）しまう<br><br>u-v	to end up ～
しみん<br>市民<br>n	citizen
じむしょ<br>事務所<br>n	office
しゃかい<br>社会<br>n	society,public
しゃちょう<br>社長<br>n	company president,manager,director
邪魔ーじゃま<br><br>adj-na,n,vs	hindrance,intrusion
ジャム<br><br>n	jam
じゆう<br>自由<br>adj-na,exp,n	freedom
しゅうかん<br>習慣<br>n	custom,habit,manners
じゅうしょ<br>住所<br>n	address (eg of house),residence,domicile not 居住
じゅうどう<br>柔道<br>n	judo
じゅうぶん<br>十分<br>	enough ,sufficient
しゅっせき・する<br>出席<br>n,vs	attendance,presence not sanka
しゅっぱつ・する<br>出発<br>n,vs	departure
しゅみ<br>趣味<br>n	hobby
じゅんび・する<br>準備<br>n	prepare
しょうかい<br>紹介<br>n,vs	introduction
しょうがつ<br>正月<br>n	New Year,New Year's Day
しょうがっこう<br>小学校<br>n	primary school,elementary school
しょうせつ<br>小説<br>n	novel,story
しょうたい・する<br>招待<br>n,vs	invitation jukugo
しょうち・する<br>承知<br>n,vs	consent,acceptance not kyoka KNOWledge, awareness
しょうらい<br>将来<br>n-adv,n-t	future,prospects
しょくじ・する<br>食事<br>n,vs	meal
しょくりょうひん<br>食料品<br>n	foodstuff,groceries
じょせい<br>女性<br>n	woman
しらせる<br>知らせる<br>ru-v	to notify,to advise
しらべる<br>調べる<br>ru-v,vt	to investigate,to check up not tazuneru
じんこう<br>人口<br>n	population
じんじゃ<br>神社<br>n	Shinto shrine
しんせつ<br>親切<br>adj-na,n	kindness,gentleness
しんぱい・する<br>心配<br>adj-na,n,vs	worry,concern
しんぶんしゃ<br>新聞社<br>n	newspaper company
すいえい<br>水泳<br>n,vs	swimming
すいどう<br>水道<br>n	water service,water supply
ずいぶん<br><br>adj-na,n-adv	extremely
すうがく<br>数学<br>n	mathematics,arithmetic
スーツ<br><br>n	suit
スーツケース<br><br>n	suitcase
スーパー（マーケット）<br><br>n	super (market)
すぎる<br>過ぎる<br>ru-v,vi	to exceed,to go beyond
空 (すく)<br><br>u-v,vi	to become empty
スクリーン<br><br>n	screen
すごい<br>凄い<br>adj	terrific,amazing,to a great extent not 大変 or 素晴らしい
すすむ<br>進む<br>u-v	to make progress,to advance,to proceed
すっかり<br><br>adv	all,completely,thoroughly (kana)
ずっと<br><br>adv,n	straight,quickly,all of a sudden
ステーキ<br><br>n	steak
ステレオ<br><br>n	stereo
すてる<br>捨てる<br>ru-v	to throw away
すな<br>砂<br>n	sand
素晴らしい (すばらしい<br><br>adj	wonderful,splendid not rippa
すべる<br>滑る<br>u-v	to slide,to slip
すみ<br>隅<br>n,n-suf	corner,nook (inside)
すむ<br>済む<br>u-v	to finish,to end intrans. not owaru
掏摸<br>すり<br><br>n	pickpocket
すると<br><br>conj	and,then
～せい<br>～製<br>	made in　～
せいかつ・する<br>生活<br>n,vs	living,life (one's daily existence),livelihood
せいさん・する<br>生産<br>ru-v,vi	production,manufacture
せいじ<br>政治<br>n	politics,government
せいよう<br>西洋<br>n	the west,Western countries
せかい<br>世界<br>n	the world
せき<br>席<br>n	seat
せつめい<br>説明<br>n,vs	explanation
せなか<br>背中<br>n	back (of body) not ura
ぜひ<br><br>adv,n	certainly,without fail not 必ず
せわ・する<br>世話<br>n,vs	looking after,help service not tetsudau or yakunitatsu
せん<br>線<br>n,n-suf	line,wire
ぜんぜん<br><br>adv	wholly,entirely
せんそう<br>戦争<br>n,vs	war
せんぱい<br>先輩<br>n	senior,superior,elder
せんもん<br>専門<br>n	speciality,study major
そう<br><br>adv	really
そうだん・する<br>相談<br>n,vs	consultation,discussion
そだてる<br>育てる<br>ru-v,vt	to raise,to rear,to bring up
そつぎょう<br>卒業<br>n,vs	graduation
そふ<br>祖父<br>n	grandfather
ソフト<br><br>n	soft
そぼ<br>祖母<br>n	grandmother not obaasan
それで<br><br>conj	and,thereupon,because of that
それに<br><br>conj	besides,moreover
それほど<br><br>adv	to that degree,extent
そろそろ<br><br>n	gradually,steadily,soon not どんどん
そんな<br><br>adj-na,adj-pn,adv,n	such,like that,that sort of
そんなに<br><br>uk	so much,like that
～だい<br>～代<br>	～ age/period
たいいん・する<br>退院<br>n,vs	leaving hospital
だいがくせい<br>大学生<br>n	college student,university student
だいじ<br>大事<br>adj-na,n	important,valuable,serious matter
だいたい<br>大体<br>n	generally,substantially not zentaiteki
たいてい<br><br>adj-na,adv,n	generally,usually
タイプ<br><br>n	type,style
だいぶ<br>大分<br>adv	considerably,greatly,a lot not 大変
たいふう<br>台風<br>n	typhoon
たおれる<br>倒れる<br>ru-v,vi	to collapse,to break down not kowareru
だから<br><br>conj,n	so,therefore
たしか<br>確か<br>adj-na,adv,exp,n	certain,sure,definite not きっと、ぜひ or 必ず
たす<br>足す<br>u-v	to add (numbers),to do (eg. one's business)
～だす<br><br>	start to ～ not hajimeru
たずねる<br>訪ねる<br>ru-v	to visit not asobi ni iku or ukagau or yoru
たずねる<br>尋ねる<br>ru-v	to ask, investigate, inquire, enquire not shiraberu
ただしい<br>正しい<br>adj	right,just,correct
たたみ<br>畳<br>n	tatami mat (Japanese straw mat)
～だて<br>建て<br>n	two storied,separate housing
たてる<br>立てる<br>ru-v	to stand (something) up,to erect (something)
たてる<br>建てる<br>ru-v	to build,to construct
たとえば<br>例えば<br>adv	for example,eg.
たな<br>棚<br>n	shelves,rack
たのしむ<br>楽む<br>u-v	to enjoy oneself
たのしみ<br>楽しみ<br>n	pleasure,joy, amusement, anticipation
偶 にーたまに<br><br>adv,suf	occasionally,once in a while
ため<br>為<br>n	good,advantage,in order to
だめ<br><br>adj-na,n	useless,no good,hopeless
たりる<br>足りる<br>ru-v	to be sufficient,to be enough
だんせい<br>男性<br>n	male,man
だんぼう<br>暖房<br>n	heating
ち<br>血<br>n	blood
チェック・する<br><br>n	check
ちから<br>力<br>n-suf	strength,power
ちっとも<br><br>adv	not at all (neg. verb)
～ちゃん<br><br>n	suffix for familiar (female) person
ちゅうい<br>注意<br>n,vs	caution,being careful,attention (heed)
ちゅうがっこう<br>中学校<br>n	junior high school,middle school pupil
ちゅうしゃ<br>注射<br>n,vs	injection
ちゅうしゃじょう<br>駐車場<br>n	parking lot,parking place
～ちょう<br>～町<br>n	～ of the town
ちり<br>地理<br>n	geography
～（に）ついて<br><br>expr	about,concerning,regarding
つかまえる<br>捕まえる<br>ru-v	to catch,to arrest,to seize
つき<br><br>n-suf	moon
～つき<br>～月<br>n-temp	month
つく<br>点く<br>u-v, intrans-verb	to be started,to be switched on
つける<br><br>ru-v	to take
つける<br>漬ける<br>ru-v	to soak,to moisten,to pickle
つごう<br>都合<br>adv,n	circumstances,condition,convenience
つたえる<br>伝える<br>ru-v	to tell,to report
つづく<br>続く<br>u-v,vi	to be continued intrans
～つづける<br>～続ける<br>ru-v,vt	to continue doing ～
つづける<br>続ける<br>ru-v,vt	to continue,to keep up,to keep on
つつむ<br>包む<br>u-v	wrap,pack
つま<br>妻<br>n	(hum) wife
つもり<br><br>n	intention,plan not yotei
つる<br>釣る<br>u-v	to fish
つれる<br>連れる<br>ru-v	to lead,to take (a person)
ていねい<br>丁寧<br>adj-na,n	polite,courteous
テキスト<br><br>n	(1)text,(2)text book
てきとう<br>適当<br>adj-na,n	fitness,suitability
できる<br><br>ru-v	to be able to do
できるだけ<br><br>	if at all possible,as much as possible
てつだう<br>手伝う<br>u-v	to lend a helping hand,to assist,to take part in<br>not tasukeru or sanka suru or yaku ni tatsu
テニス<br><br>n	tennis
てぶくろ<br>手袋<br>n	glove
てら<br>寺<br>n	temple
てん<br>点<br>n,n-suf	spot,mark,point,dot
てんいん<br>店員<br>n	shop assistant,employee,clerk,salesperson
てんきよほう<br>天気予報<br>	weather forecast,weather report
でんとう<br>電灯<br>n	electric light not just the juice itself
でんぽう<br>電報<br>n	telegram
てんらんかい<br>展覧会<br>n	exhibition
と<br>都<br>n	metroplitan,municipal
どうぐ<br>道具<br>n	tool,means
とうとう<br><br>	finally,at last not yatto or saigo
どうぶつえん<br>動物園<br>n	zoo
とおく<br>遠く<br>adj-no,n-adv,n	far away,distant
とおり<br>通り<br>n-suf	～ Street,～ Avenue
とおる<br>通る<br>u-v	to pass (by),to go through
とくに<br>特に<br>adv	particularly,especially not betsu
とくべつ<br>特別<br>adj-na,adv,n	special
床屋ーとこや<br><br>n	barber
とちゅう<br>途中<br>n-adv,n-t	on the way,en route,midway
とっきゅう<br>特急<br>n	limited express (train, faster than an express)
とどける<br>届ける<br>ru-v	to deliver
とまる<br>泊まる<br>u-v	to stay at (eg. hotel)
とめる<br>止める<br>ru-v,vt	to stop (something)
とりかえる<br>取り替える<br>ru-v	to exchange,to replace not 代わる, to take and replace with another
どろぼう<br>泥棒<br>n,vs	thief,burglar,robber
どんどん<br><br>adv	steadily,little by little
なおす<br>直す<br>u-v,vt	to fix,to repair
なおる<br>直る<br>u-v,vi	to be fixed,to be repaired
なおる<br>治る 直る<br>u-v,vi	to be cured,to heal not 癒す
なかなか<br>中々<br>adv	very,considerably,quite not ほとんど or とても
なく<br>泣く<br>u-v	to cry,to weep
なくなる<br>無くなる<br>u-v	to disappear,to get lost
なくなる<br>亡くなる<br>u-v	to die pol.
なげる<br>投げる<br>ru-v	to throw,to cast away not suteru
なさる<br><br>aru-v	(hon) to do
なる<br>鳴る<br>u-v	to sound,to ring,to resound
なるべく<br><br>adv	as much as possible - not dekiru dake
なるほど<br><br>adv,exp	I see,now I understand
なれる<br>慣れる<br>ru-v	to grow accustomed to
匂い - におい<br><br>ru-v	odour,scent,smell
にがい<br>苦い<br>adj	bitter
～にくい<br><br>suf	difficult to do ～
にげる<br>逃げる<br>ru-v	to escape,to run away
にっき<br>日記<br>n	diary,journal
にゅういん・する<br>入院<br>n,vs	hospitalization
にゅうがく・する<br>入学<br>n	entry to school or university,matriculation
にる<br>似る<br>ru-v	to resemble,to be similar
にんぎょう<br>人形<br>n	doll,puppet,figure
ぬすむ<br>盗む<br>u-v	to steal
ぬる<br>塗る<br>u-v	to paint,to plaster
濡(ぬ)れる<br><br>ru-v	to get wet
ねだん<br><br>n	price,cost
ねつ<br>熱<br>n,n-suf	fever,temperature
ねっしん<br><br>adj-na,n	zeal,enthusiasm
ねぼう<br>寝坊<br>n,vs	sleeping in late
ねむい<br>眠い<br>adj	sleepy,drowsy
ねむる<br>眠る<br>u-v	to sleep not necc. lying down
のこる<br>残る<br>u-v	to remain,to be left
のど<br><br>n	throat
のりかえる<br>乗り換える<br>ru-v	to transfer (trains),to change (bus, train)
のりもの<br>乗り物<br>n	vehicle
は<br>葉<br>n	leaf
ばあい<br>場合<br>n-adv,n	case,situation
パート（タイム）<br><br>n-adv,n	part time (esp female part time employees)
ばい<br>倍<br>n,vi,vs,vt	twice,double
はいけん・する<br>拝見<br>n,vs	(hum) (pol) seeing,look at not goranninaru
はいしゃ<br>歯医者<br>n	dentist
～ばかり<br><br>suf	just did ～,only
はこぶ<br>運ぶ<br>v5b	to transport,to carry
～はじめる<br>～始める<br>ru-v,vt	to start doing　～,the beginning of ～
はじめる<br>始める<br>ru-v,vt	to start,to begin
ばしょ<br>場所<br>n	place,location
はず<br><br>n	it should be so
はずかしい<br>恥ずかしい<br>adj	shy,ashamed,embarrassed
パソコン<br><br>n	(personal) computer
はつおん<br>発音<br>n,vs	pronunciation
はっきり<br><br>adv,n	clearly,plainly,distinctly
はなみ<br>花見<br>n,vs	cherry-blossom viewing,flower viewing
パパ<br><br>n	papa,father
はやし<br>林<br>n	woods,forester
はらう<br>払う<br>u-v	to pay
ばんぐみ<br>番組<br>n	program (eg. TV)
はんたい<br>反対<br>adj-na,n,vs	oppose,opposition,resistance
ハンバーグ<br><br>n	hamburger (meat, no bun)
ひ<br>日<br>n-adv,n-t	sun,sunshine,day
ひ<br>火<br>n,n-suf	fire,flame,blaze
ピアノ<br><br>n	piano
ひえる<br>冷える<br>ru-v,vi	to grow cold,to get chilly,to cool down
ひかる<br>光る<br>ru-v,vi	to shine,to glitter not kagayaku
ひかり<br>光<br>n	light
ひきだし<br>引き出し<br>n	drawer,drawing out
ひげ<br><br>n	beard
ひこうじょう<br>飛行場<br>n	airport not kuukou
ひさしぶり<br>久しぶり<br>exp	after a long time
びじゅつかん<br>美術館<br>n	art gallery,art museum
ひじょうに<br>非常に<br>adv	very,extremely,exceedingly, exceptionally
びっくりする<br><br>vs	to be surprised
ひっこす<br>引っ越す<br>u-v	to move,to change residence not 移る
ひつよう<br>必要<br>adj-na,n	necessary,essential
酷い (ひどい<br><br>adj	cruel,awful
ひらく<br>開く<br>u-v	to open (eg. a festival)
ビル<br><br>n	(abbr) building,bill
ひるま<br>昼間<br>n-adv,n-t	daytime,during the day
ひるやすみ<br>昼休み<br>n-adv,n-t	lunch break,noon recess,noon rest period
ひろう<br>拾う<br>u-v	to pick up,to find,to gather not atsumeru
ファックス<br><br>ru-v,vi	fax
ふえる<br>増える<br>ru-v,vi	to increase,to multiply
ふかい<br>深い<br>adj	deep,profound,thick not 濃い
ふくざつ<br>複雑<br>adj-na,n	complexity,complication
ふくしゅう<br>復習<br>n,vs	review,revision
ぶちょう<br>部長<br>adjn	head of a section
ふつう<br>普通<br>adj-na,adj-no,adv,n	(1) generally,ordinarily,usually,(2) train that stops at every station
ぶどう<br><br>n	grapes
ふとる<br>太る<br>u-v	to grow fat (stout, plump),to become fat
ふとん<br>布団<br>n	bedding (Japanese style),futon
ふね<br>舟<br>n	ship,boat
ふべん<br>不便<br>adj-na,n	inconvenience
ふむ<br>踏む<br>u-v	to step on,to tread on
プレゼント<br><br>n	present,gift
ぶんか<br>文化<br>n	culture,civilization
ぶんがく<br>文学<br>n	literature (study)
ぶんぽう<br>文法<br>n	grammar
べつ<br>別<br>adj-na,n,n-suf	separate, another
ベル<br><br>n	bell
へん<br>変<br>adj-na,n	strange,odd,peculiar
へんじ<br>返事<br>n,vs	reply,answer not kotae
ぼうえき<br>貿易<br>n	trade (foreign)
ほうそう・する<br>放送<br>n,vs	broadcast,broadcasting
ほうりつ<br>法律<br>n	law
ぼく<br>僕<br>n	(male) I,manservant
ほし<br>星<br>n	star
ほど<br><br>n	degree,extent
ほとんど<br><br>n-adv,n-t	mostly,almost not daibu or zentaiteki (hiragana)
ほめる<br><br>ru-v	to praise
ほんやく<br>翻訳<br>n,vs	translation (written)
まいる<br>参る<br>u-v	(1) (hum) to go,to come
まける<br>負ける<br>ru-v	to lose,to be defeated
まじめ<br><br>adj-na,n	diligent,serious
まず<br><br>adv	first (of all),to start with not saisho or hajimeni
または<br><br>conj,exp	or,otherwise
まちがえる<br>間違える<br>ru-v	to err,to make a mistake
まにあう<br>間に合う<br>u-v	(1) to be in time for
～まま<br><br>n	as it is
まわり<br>周り<br>n,n-suf	surroundings,circulation not kairan
まわる<br>回る<br>u-v	to go around,to revolve
まんが<br>漫画<br>n	comic,cartoon
まんなか<br>真中<br>n	middle,centre
みえる<br>見える<br>ru-v	to be seen,to be in sight
みずうみ<br>湖<br>n	lake
みそ<br>味噌<br>n	miso,bean paste
みつかる<br>見つかる<br>u-v	(uk) to be found,to be discovered
みつける<br>見つける<br>ru-v	to discover,to find not hakken
みな<br>皆<br>adv,n	everyone,everybody
みなと<br>港<br>n	harbour,port
むかえる<br>迎える<br>u-v	to go out to meet
むかう<br>向かう<br>u-v	to face,to go towards
むかし<br>昔<br>adj-no,n-adv,n-t	olden days,former
むし<br>虫<br>n	insect
むすこ<br>息子<br>n	(hum) son
むすめ<br>娘<br>n	(hum) daughter
むり<br>無理<br>adj-na,n,vs	unreasonable,impossible
～め<br>～目<br>suf	number ～ sequence,～nd/th not ban
めしあがる<br>召し上がる<br>u-v	(pol) to eat
めずらしい<br>珍しい<br>adj	unusual,rare
もうしあげる<br>申し上げる<br>ru-v	to say,to tell multikanji
もうす<br>申す<br>u-v	(hum) to be called,to say
もうすぐ<br><br>expr	soon, very soon
もし<br><br>adv	if
もちろん<br><br>adv	certainly,of course
もっとも<br><br>adv	most,extremely
もどる<br>戻る<br>u-v	to turn back,to return not kaeru
もめん<br>木綿<br>n	cotton
もらう<br><br>u-v	to receive not ukeru or itadaku
もり<br>森<br>n	forest
やく<br>焼く<br>u-v	to bake,to grill
やくにたつ<br>役に立つ<br>u-v	to be helpful,to be useful - not sewa or tetsudau or tasukaru
やくそく<br>約束<br>n,vs	arrangement,promise
やける<br>焼ける<br>ru-v,vi	to burn,to be roasted,to be sunburnt
やさしい<br>優しい<br>adj	kind,gentle not 親切
～やすい<br><br>	easy to do ～
やせる<br><br>ru-v	to become thin,to lose weight
やっと<br><br>adv	at last,at length
やはり/やっぱり<br><br>adv,exp	as I thought,absolutely not naruhodo
やむ<br><br>u-v,vi	to cease,to stop intrans not 止まる
やめる<br>止める<br>ru-v	to end,to stop,to resign - not akirameru trans.
やる<br><br>u-v	(col)to do
やわらかい<br>柔らかい<br>adj	soft,tender
ゆ<br>湯<br>n	hot water
ゆうはん<br>夕飯<br>n	evening meal not bangohan
ゆしゅつ・する<br>輸出<br>n,vs	export
ゆにゅう・する<br>輸入<br>n,vs	import
ゆび<br>指<br>n	finger
ゆびわ<br>指輪<br>n	(finger) ring
ゆめ<br>夢<br>n	dream
ゆれる<br>揺れる<br>ru-v	to shake,to sway not 振る
よう<br>様<br>adj-na	(in this) way,manner,kind not かた or ふ
よう<br>用<br>n,n-suf	task,business,use - one kanji
ようい<br>用意<br>n,vs	preparation not junbi or shitaku
ようじ<br>用事<br>n	tasks,chores
よごれる<br>汚れる<br>ru-v	to get dirty,to become dirty
よしゅう<br>予習<br>n,vs	preparation for a lesson
よてい<br>予定<br>n,vs	plans,arrangement,schedule not keikaku or sekkei
よやく<br>予約<br>n,vs	reservation,booking
よる<br>寄る<br>u-v	to visit,to drop in
（～に）よると<br><br>	according to ～
よろこぶ<br>喜ぶ<br>v5b	to be delighted,to be glad not ureshii or shiawase
よろしい<br><br>adj	(hon) good,OK,all right
りゆう<br>理由<br>n	reason,pretext,motive
りよう<br>利用<br>n,vs	use,utilization not you
りょうほう<br>両方<br>n	both sides,both parties
りょかん<br>旅館<br>n	Japanese hotel,inn
るす<br>留守<br>n	absence,being away from home
れいぼう<br>冷房<br>n	cooling,air conditioning
れきし<br>歴史<br>n	history
レジ<br><br>n	register
レポート/リポート<br><br>n	report,essay,assignment (aus)
れんらく<br>連絡<br>n,vs	communication,contact,connection
ワープロ<br><br>n	word processor
わかす<br>沸かす<br>u-v,vt	to boil,to heat
わかれる<br>別れる<br>ru-v	to be divided,to part from,to separate
わく<br>沸く<br>u-v	to boil,to grow hot,to get excited
わけ<br>訳<br>n	meaning,reason (1 kanji)
わすれもの<br>忘れ物<br>n	lost article,something forgotten
わらう<br>笑う<br>u-v	to laugh,to smile
わりあい<br>割合<br>adv,n	rate,ratio,percentage
われる<br>割れる<br>ru-v,vi	to break (glass intrans.)
あう<br>会う<br>u-v	to meet,to see
あお<br>青<br>n	blue
あおい<br>青い<br>adj	blue
あか<br>赤<br>n	red
あかい<br>赤い<br>adj	red
あかるい<br>明るい<br>adj	bright,cheerful
あき<br>秋<br>n-adv	autumn,fall
あく<br>開く<br>u-v,vi	to open,to become open
あける<br>開ける<br>ru-v	to open trans
あげる<br>上げる<br>ru-v	to give
あさ<br>朝<br>n-adv,n-t	morning
あさごはん<br>朝御飯<br>n	breakfast
あさって<br><br>n-adv,n-t	day after tomorrow
あし<br>足<br>n	foot,leg
あした<br><br>n-t	tomorrow
あそこ<br><br>n	there,over there,that place
あそぶ<br>遊ぶ<br>u-v	to play,to enjoy oneself
あたたかい<br>暖かい<br>adj	warm,mild
あたま<br>頭<br>n	head
あたらしい<br>新しい<br>adj	new
あちら<br><br>n	there,yonder,that not mukou
あつい<br>暑い<br>adj	hot,warm, sultry - not atatakai
あつい<br>熱い<br>adj	hot (thing)
あつい<br>厚い<br>adj	kind,warm(hearted),thick,deep
あっち<br><br>n col	over there
あと<br>後<br>adj-no,n	afterwards,since then,in the future, not これから
あなた<br><br>n	you
あに<br>兄<br>n	(hum) older brother
あね<br>姉<br>n	(hum) older sister
あの<br><br>pren-adj	that over there
あの<br><br>int	um...
アパート<br><br>n,adv	apartment (abbr)
浴びるーあびる<br><br>ru-v	to bathe,to shower
あぶない<br>危ない<br>adj	dangerous,critical,watch out!
あまい<br>甘い<br>adj,expr	generous,sweet
あまり<br><br>na-adj,adv,n,n-suf	not very,not much
あめ<br>雨<br>n	rain
あめ<br />飴<br />n	(hard) candy,toffee
あらう<br>洗う<br>u-v	to wash
ある [存在]<br><br>u-v-i	to be
ある [所有]<br><br>u-v-i	to have
あるく<br>歩く<br>u-v	to walk
あれ<br><br>int,n	that,that thing
いい/よい<br><br>adj	good
いいえ<br><br>int,n	no,not at all
いう<br>言う<br>u-v	to say
いえ<br>家<br>suf	house,family
いかが<br><br>na-adj,adv,n	how,in what way
いく/ゆく<br>行く<br>u-v	to go
いくつ<br><br>n	how many?,how old?
いくら<br><br>adv,n	how much?,how many? not ikutsu
いけ<br>池<br>n	pond
いしゃ<br>医者<br>n	doctor (medical)
椅子ーいす<br><br>n	chair
いそがしい<br>忙しい<br>adj	busy,irritated
いたい<br>痛い<br>adj	painful
いち<br>一<br>num	one
いちにち<br>一日<br>n	1 day (duration)
いちばん<br><br>n-adv	best,first,number one
いつ<br><br>gn-adv	when
いつか<br>五日<br>n	five days,the fifth day (of the month)
いっしょ<br>一緒<br>adv,n	together
いつつ<br>五つ<br>n	five
いつも<br><br>adv,n	always,every time not zutto
いぬ<br>犬<br>	dog
いま<br>今<br>	now
いみ<br>意味<br>n,vs	meaning
いもうと<br>妹<br>n	younger sister
いや<br>嫌<br>na-adj,n	disagreeable,no
いりぐち<br>入口<br>n	entrance,gate not mon
おる<br>居る<br>u-v	(hum) to be (animate),to exist
いる<br>要る<br>u-v	to need
いれる<br>入れる<br>ru-v	to put in
いろ<br>色<br>n	colour
いろいろ<br><br>na-adj,adj-no,adv,n	various
うえ<br>上<br>no-adj,n-adv,n,n-suf	above,on top of
うしろ<br>後ろ<br>n	behind,rear not ura
うすい<br>薄い<br>adj	thin,weak
うた<br>歌<br>n	song
うたう<br>歌う<br>u-v	to sing
うまれる<br>生まれる<br>ru-v	to be born
うみ<br>海<br>n	sea,beach not kaigan
うる<br>売る<br>u-v	to sell trans.
うるさい<br><br>adj	noisy,loud,annoying
うわぎ<br>上着<br>n	coat,jacket
え<br>絵<br>n,n-suf	picture,drawing,painting,sketch
えいが<br>映画<br>n	movie,film
えいがかん<br>映画館<br>n	movie theatre (theater),cinema
えいご<br>英語<br>n	the English language
ええ<br><br>conj,int,n	yes
えき<br>駅<br>n	station
エレベーター<br><br>n	elevator
～えん<br>～円<br>n	yen (currency)
えんぴつ<br>鉛筆<br>n	pencil
お～<br><br>prefix	honourable ～ (honorific)
美味しいーおいしい<br><br>adj	delicious,tasty not umai
おおい<br>多い<br>adj	many
おおきい<br>大きい<br>adj	big
おおきな<br>大きな<br>na-adj	big
おおぜい<br>大勢<br>n	great number of people
おかあさん<br>お母さん<br>n	(hon) mother
おかし<br>お菓子<br>n	confections,sweets,candy
おかね<br>お金<br>n	money
おきる<br>起きる<br>ru-v	to get up,to rise out of bed
おく<br>置く<br>u-v	to put,to place
おくさん<br>奥さん<br>n	(hon) wife
おさけ<br>お酒<br>n	alcohol,sake (rice wine)
おさら<br>お皿<br>n	plate,dish
おじ・さん<br>伯父/叔父・さん<br>n	uncle,middle aged man
おじいさん<br><br>n	grandfather,male senior citizen not sofu
おしえる<br>教える<br>ru-v	to teach,to inform
おす<br>押す<br>u-v,vt	to push,to press
おそい<br>遅い<br>adj	late,slow
おちゃ<br>お茶<br>n	tea (green)
おてあらい<br>お手洗い<br>	toilet,lavatory,bathroom
おとうさん<br>お父さん<br>n	(hon) father
おとうと<br>弟<br>n	younger brother
おとこ<br>男<br>n	man
おとこのこ<br>男の子<br>n	boy
おととい<br><br>n-adv,n-t	day before yesterday
おととし<br><br>n-adv,n-t	year before last
おとな<br>大人<br>n	adult
おなか<br><br>n	stomach
おなじ<br>同じ<br>na-adj,n	same,identical,similar
おにいさん<br>お兄さん<br>n	(hon) older brother
おねえさん<br>お姉さん<br>n	(hon) older sister
おばさん<br>伯母さん/叔母さん<br>n	aunt
おばあさん<br><br>n	grandmother,female senior-citizen
おふろ<br>お風呂<br>n	bath
おべんとう<br>お弁当<br>n	boxed lunch
おぼえる<br>覚える<br>ru-v	to remember,to memorize
おまわりさん<br><br>n	policeman (friendly term)
おもい<br>重い<br>adj	heavy
おもしろい<br><br>adj	interesting,amusing
およぐ<br>泳ぐ<br>u-v	to swim
おりる<br>降りる<br>ru-v	to alight (eg from bus),to get off
おわる<br>終る<br>u-v	to finish,to close not sumu intrans.
おんがく<br>音楽<br>n	music
おんな<br>女<br>n	woman,girl,daughter
おんなのこ<br>女の子<br>n	girl
～かい<br>～回<br>n	counter for occurrences not do
～かい<br>～階<br>n	counter for storeys of a building
がいこく<br>外国<br>n	foreign country
がいこくじん<br>外国人<br>n	foreigner
かいしゃ<br>会社<br>n	company,corporation
かいだん<br>階段<br>n	stairs
かいもの<br>買い物<br>n	shopping
かう<br>買う<br>u-v	to buy
かえす<br>返す<br>u-v,vt	to return something
かえる<br>帰る<br>u-v	to go home,to return
かお<br>顔<br>n	face (person)
かかる<br><br>u-v,vi	to take (eg time, money)
鍵ーかぎ<br><br>n	key/s
かく<br>書く<br>u-v	to write
がくせい<br>学生<br>n	student
～かげつ<br>～か月<br>suf	(number of) months
眼鏡を掛ける	to put on (eg glasses)
かさ<br>傘<br>n	umbrella
かす<br>貸す<br>u-v	to lend
かぜ<br>風<br>n	wind,breeze
かぜ<br>風邪<br>n	cold,illness
かた<br>方<br>n	person
かぞく<br>家族<br>n	family
かたかな<br>片仮名<br>n	katakana
～がつ<br>～月<br>suf	month of year
がっこう<br>学校<br>n	school
カップ<br><br>n	cup
かてい<br>家庭<br>n	home,household not kazoku
かど<br>角<br>n	corner (e.g. desk) not sumi
鞄ーかばん<br><br>n	bag,basket not fukuro
かびん<br>花瓶<br>n	(flower) vase
被るーかぶる<br><br>u-v	to wear,to put on (head)
かみ<br>紙<br>n	paper
カメラ<br><br>n	camera
かようび<br>火曜日<br>n-adv,n	Tuesday
からい<br>辛い<br>adj	spicy,salty
からだ<br>体<br>n	body
かりる<br>借りる<br>ru-v	to borrow,to have a loan
～がる<br><br>suf	(make people) feel
かるい<br>軽い<br>adj	light,non-serious,minor
カレー<br><br>n	curry
カレンダー<br><br>n	calendar
かわ<br>川/河<br>n	river
～がわ<br>側<br>n-suf	～ side
かわいい<br><br>adj	cute,charming
かんじ<br>漢字<br>n	kanji,Chinese character
き<br>木<br>n	tree,wood
きいろ<br>黄色<br>n	yellow
きいろい<br>黄色い<br>adj	yellow
きえる<br>消える<br>ru-v	to go out (light),to vanish
きく<br>聞く<br>u-v	to hear,to listen,to ask
きた<br>北<br>	north
ギター<br><br>n	guitar
きたない<br>汚い<br>adj	dirty,messy
きっさてん<br>喫茶店<br>n	coffee lounge
きって<br>切手<br>n	stamp (eg. postage)
きっぷ<br>切符<br>n	ticket
きのう<br>昨日<br>n-adv,n-t	yesterday
きゅう<br>九<br>num	nine
ぎゅうにく<br>牛肉<br>n	beef
ぎゅうにゅう<br>牛乳<br>n	milk
きょう<br>今日<br>n-t	today,this day
きょうしつ<br>教室<br>n	classroom
きょうだい<br>兄弟<br>n	siblings (brothers and sisters)
きょねん<br>去年<br>n-adv,n-t	last year
きらい<br>嫌い<br>na-adj,n	dislike,hate
きる<br>切る<br>suf,u-v	to cut,to chop
きる<br>着る<br>ru-v	to wear,to put on (from shoulders down)
綺麗ーきれい<br><br>na-adj	pretty,clean,nice,tidy
キロ/キログラム<br><br>n,pref	kilo (kilogram)
キロ/キロメートル<br><br>n,pref	kilo (kilometre)
ぎんこう<br>銀行<br>n	bank
きんようび<br>金曜日<br>n-adv,n	Friday
く<br>九<br>number	nine
くすり<br>薬<br>n	medicine
ください<br><br>kana only	(with te-form verb) please do for me
くだもの<br>果物<br>n	fruit
くち<br>口<br>n	mouth,orifice,opening
くつ<br>靴<br>n	shoes,footwear
くつした<br>靴下<br>n	socks
くに<br>国<br>n	country
くもり<br>曇り<br>adv	cloudiness,cloudy weather
くもる<br>曇る<br>u-v	to become cloudy,to become dim
くらい<br>暗い<br>adj	dark,gloomy
～くらい/ぐらい<br><br>suf	approximate (quantity)
クラス<br><br>n	class
グラム<br><br>n	gram
くる<br>来る<br>vk	to come
くるま<br>車<br>n	car,vehicle
くろ<br>黒<br>n	black
くろい<br>黒い<br>adj	black
けいかん<br>警官<br>n	policeman
けさ<br>今朝<br>n-temp	this morning
けす<br>消す<br>u-v	to erase,to delete,to turn off power not kiru
けっこう<br>結構<br>na-adj,n-adv,n	nice,enough
けっこん（する）<br>結婚<br>adj-no,n,vs	marriage
げつようび<br>月曜日<br>n-adv,n	Monday
げんき<br>元気<br>na-adj,n	health not kenkou
～こ<br>～個<br>n,suf	counter for small items
ご<br>五<br>num	five
～ご<br>～語<br>n,n-suf	word,language not kotoba
こうえん<br>公園<br>n	(public) park
こうさてん<br>交差点<br>n	intersection
こうちゃ<br>紅茶<br>n	black tea
こうばん<br>交番<br>n	police box
こえ<br>声<br>n	voice
コート<br><br>n	coat
コーヒー<br><br>n	coffee
ここ<br><br>n	here,this place
ごご<br>午後<br>n-adv,n-t	afternoon,P.M.
ここのか<br>九日<br>	nine days,the ninth day (of the month)
ここのつ<br>九つ<br>n	nine
ごぜん<br>午前<br>n-adv,n-t	morning,A.M.
こたえる<br>答える<br>ru-v	to answer,to reply
こちら<br><br>n	this eg person, way
コップ<br><br>n	cup
ことし<br>今年<br>n-adv,n-t	this year
ことば<br>言葉<br>n	word
こども<br>子供<br>n	child,children
この<br><br>adj-pn,int	this
ごはん<br>御飯<br>n	rice (cooked),meal
コピー・する<br><br>n,p-suru	to copy
こまる<br>困る<br>u-v	to be worried,to be bothered not 心配 する
これ<br><br>int,n	this
～ころ/～ごろ<br><br>n-suf	about,approximately (time)
こんげつ<br>今月<br>n-adv,n-t	this month
こんしゅう<br>今週<br>n-adv,n-t	this week
こんな<br><br>na-adj,adj-pn,adv,n	such,like this
こんばん<br>今晩<br>n-adv,n-t	tonight,this evening
さあ<br><br>conj,int	come now, well
～さい<br>～歳<br>suf	～years-old
さいふ<br>財布<br>n	wallet
さかな<br>魚<br>n	fish
さき<br>先<br>adj-no,n,n-suf,pref	the future,former,previous
さく<br>咲く<br>u-v	to bloom
さくぶん<br>作文<br>n	composition,writing not bunshou
さす<br>差す<br>u-v	to raise (stretch out) hands,to raise (eg umbrella)
～さつ<br>～冊<br>n	counter for books
ざっし<br>雑誌<br>n	magazine
さとう<br>砂糖<br>n	sugar
さむい<br>寒い<br>adj	cold (e.g. weather)
さらいねん<br>さ来年<br>n-adv,n-t	year after next
～さん<br><br>suf	Mr or Mrs
さん<br>三<br>num	three
さんぽ（する）<br>散歩<br>n,vs	walk,stroll
し<br>四<br>num	four
～じ<br>～時<br>suf	time (～ O'clock)
しお<br>塩<br>n	salt
しかし<br><br>conj	however,but
じかん<br>時間<br>n-adv,n	time
～じかん<br>～時間<br>suf	～hours
しごと<br>仕事<br>adj-no,n	work,occupation,employment
じしょ<br>辞書<br>n	dictionary not jibiki or jiten
しずか<br>静か<br>na-adj	quiet,peaceful
した<br>下<br>n	under,below,beneath
しち<br>七<br>num	seven
しつもん<br>質問<br>n,vs	question,inquiry
じてんしゃ<br>自転車<br>n	bicycle
じどうしゃ<br>自動車<br>n	automobile
しぬ<br>死ぬ<br>v5n	to die
じびき<br>字引<br>n	dictionary not jiten or jishou
じぶん<br>自分<br>n	myself,oneself
しまる<br>閉まる<br>u-v,vi	to close,to be closed
しめる<br>閉める<br>ru-v,vt	to close,to shut trans.
しめる<br>締める<br>ru-v	to tie,to fasten
じゃ/じゃあ<br><br>conj,int	well,well then
しゃしん<br>写真<br>n	photograph
シャツ<br><br>n	shirt,singlet
シャワー<br><br>n	shower
じゅう<br>十<br>num	ten
～じゅう<br>～中<br>suf	during,while
～しゅうかん<br>～週間<br>suf	～weeks
じゅぎょう<br>授業<br>n,vs	lesson,class work
しゅくだい<br>宿題<br>n	homework
じょうず<br>上手<br>na-adj,n	skill,skillful,dexterity not gijutsu
じょうぶ<br>丈夫<br>na-adj,n	strong,solid,durable
しょうゆ<br><br>n	soy sauce
しょくどう<br>食堂<br>n	cafeteria,dining hall
しる<br>知る<br>u-v	to know,to understand
しろ<br>白<br>n	white
しろい<br>白い<br>adj	white
～にん<br>～人<br>n,suf	counter for people
しんぶん<br>新聞<br>n	newspaper
すいようび<br>水曜日<br>n-adv,n	Wednesday
すう<br>吸う<br>u-v	to smoke,to breathe in,to suck
スカート<br><br>n	skirt
すき<br>好き<br>na-adj,n	liking,fondness,love
～すぎ<br><br>suf	to exceed,～ too much
すくない<br>少ない<br>adj	a few,scarce
すぐ・に<br><br>adv	immediately,instantly
すこし<br>少し<br>adv,n	little,few
すずしい<br>涼しい<br>adj	cool,refreshing
～ずつ<br><br>suf	at a time,gradually
ストーブ<br><br>n	heater (lit: stove)
スプーン<br /><br />n	spoon
スポーツ<br><br>n	sport
ズボン<br><br>n	trousers (fr: jupon)
すむ<br>住む<br>u-v	to reside,to live in
スリッパ<br><br>n	slippers
する<br><br>vs-i	to do,to try
すわる<br>座る<br>u-v	to sit
せい<br>背<br>n	height,stature
せいと<br>生徒<br>n	pupil
セーター<br><br>n	sweater,jumper
せっけん<br>石鹸<br>n	soap
せびろ<br>背広<br>n	business suit
せまい<br>狭い<br>adj	narrow,confined,small
ゼロ<br><br>n	zero
せん<br>千<br>	thousand,many
せんげつ<br>先月<br>n-adv,n-t	last month
せんしゅう<br>先週<br>n-adv,n-t	last week,the week before
せんせい<br>先生<br>n	teacher,master,doctor
せんたく<br>洗濯<br>n,vs	washing,laundry
ぜんぶ<br>全部<br>n-adv,n-t	all,entire,whole
そう/そうです<br><br>	appears,to be the case
そうじ（する）<br>掃除<br>n,vs	cleaning,sweeping
そうして/そして<br><br>conj	and,like that
そこ<br><br>n	that place,there
そちら<br><br>n	over there by you, not mukou
そっち<br><br>n	over there
そと<br>外<br>n	outside, exterior not omote
その<br><br>adj-pn	that
側 (そば<br><br>n	near,close,beside, side
そら<br>空<br>n	sky
それ<br><br>n	it,that
それから	and then,after that
それでは<br><br>exp	in that situation,well then...
～だい<br>～台<br>suf	counter for vehicles/machines
だいがく<br>大学<br>n	university
たいしかん<br>大使館<br>n	embassy
だいじょうぶ<br>大丈夫<br>na-adj,adv,n	safe,all right,O.K.
だいすき<br>大好き<br>na-adj,n	very likeable,like very much
たいせつ<br>大切<br>na-adj,n	important
だいどころ<br>台所<br>n	kitchen
たいへん<br><br>na-adj,adv,n	very
たかい<br>高い<br>adj	tall,high
～だけ<br><br>prt	only ～,just ～
たくさん<br><br>na-adj,adv,n	many,a lot,much
タクシー<br><br>n	taxi
だす<br>出す<br>u-v	to put out,to send
～たち<br><br>n-suf	plural suffix
たつ<br>立つ<br>u-v	to stand
縦 - たて<br><br>n	length,height
たてもの<br>建物<br>n	building not biru
たのしい<br>楽しい<br>adj	enjoyable,fun
たのむ<br>頼む<br>u-v	to request,to ask
たばこ<br><br>n	tobacco,cigarettes
たぶん<br><br>adv,n	perhaps,probably
たべもの<br>食べ物<br>n	food
たべる<br>食べる<br>ru-v	to eat
たまご<br>卵<br>n	egg(s)
だれ<br>誰<br>n	who
だれか<br>誰か<br>n	someone,somebody
たんじょうび<br>誕生日<br>n	birthday
だんだん<br><br>adv,n	gradually,by degrees not どんどん
ちいさい<br>小さい<br>adj	small,little
ちいさな<br>小さな<br>na-adj	small,little
ちかい<br>近い<br>adj,suf	near,close by,short
ちがう<br>違う<br>u-v	to differ (from)
ちかく<br>近く<br>n-adv,n	near
ちかてつ<br>地下鉄<br>n	underground train,subway
ちず<br>地図<br>n	map
ちち<br>父<br>n	(one's own) father
ちゃいろ<br>茶色<br>n	brown
ちゃわん<br><br>n	rice bowl
～ちゅう<br>～中<br>suf	during,while ～ing
ちょうど<br><br>gn	just,right,exactly
ちょっと<br><br>adv,int	a little,somewhat
ついたち<br>一日<br>n	for one day,first of month
つかう<br>使う<br>u-v	to use
つかれる<br>疲れる<br>ru-v	to get tired,to tire
つぎ<br>次<br>n	next
つく<br>着く<br>u-v	to arrive at,to reach
つくえ<br>机<br>n	desk
つくる<br>作る<br>u-v	to make,to create
点けるーつける<br><br>ru-v,vt	to turn on (eg a light)
つとめる<br>勤める<br>ru-v	to serve,to work (for)
詰まらない<br>つまらない<br><br>adj	insignificant,boring
つめたい<br>冷たい<br>adj	cold (to the touch not weather)
つよい<br>強い<br>adj	strong,powerful
て<br>手<br>n	hand
テープ<br><br>n	tape
テープレコーダー<br><br>n	tape recorder
テーブル<br><br>n	table
でかける<br>出かける<br>ru-v	to depart,to go out not 出る or 出発する
てがみ<br>手紙<br>n	letter (for posting)
でぐち<br>出口<br>n	exit
テスト<br><br>n,vs	test
では<br><br>expr	with that...
デパート<br><br>n	department store
でも<br><br>conj,prt	but,however
でる<br>出る<br>ru-v	to appear,to leave
テレビ<br><br>n	television,TV
てんき<br>天気<br>n	weather
でんき<br>電気<br>n	electricity,(electric) light
でんしゃ<br>電車<br>n	electric train
でんわ<br>電話<br>n,vs	telephone
と<br>戸<br>n	door (Japanese style)
～ど<br>～度<br>n-suf	counter for occurrences
ドア<br><br>n	door (Western style)
トイレ<br><br>n	toilet
どう<br><br>adv	how,in what way
どうして<br><br>adv,int	why?,for what reason
どうぞ<br><br>adv	please,kindly,by all means
どうぶつ<br>動物<br>n	animal
どうも<br><br>adv,int	thanks,very
とお<br>十<br>num	ten
とおい<br>遠い<br>adj	far,distant
とおか<br>十日<br>	ten days,the tenth (day of the month)
～とき<br>～時<br>adv,n	at the time of ～
ときどき<br>時々<br>adv,n	sometimes
とけい<br>時計<br>n	watch,clock
どこ<br><br>n	where,what place
ところ<br>所<br>n	place not basho
とし<br>年<br>n	year,age
としょかん<br>図書館<br>n	library
どちら<br><br>n	which,which way
どっち<br><br>n	which one,which way
とても<br><br>adv	very
どなた<br><br>n	who - polite
となり<br>隣<br>n	next to,next door to, neighbouring
どの<br><br>pren-adj	which not dore or dochira
とぶ<br>飛ぶ<br>u-v	to fly,to hop
とまる<br>止まる<br>u-v	to come to a halt
ともだち<br>友達<br>n	friend
どようび<br>土曜日<br>n-adv,n	Saturday
とり<br>鳥<br>n	bird
とりにく<br>とり肉<br>n	chicken meat
とる<br>取る<br>u-v	to take
とる<br>撮る<br>u-v	to take (a photo)
どれ<br><br>n	which (of three or more)
どんな<br><br>na-adj,adj-pn,n	what,what kind of
ない<br><br>adj	there isn't,doesn't have
ナイフ<br><br>n	knife
なか<br>中<br>n	inside,middle,among
ながい<br>長い<br>adj	long
～ながら<br><br>prt	while ~ing,during,although
なく<br>鳴く<br>u-v	to sing (bird),to make sound (animal)
なくす<br>無くす<br>u-v	to lose something not 失う
なぜ<br><br>adv	why
なつ<br>夏<br>n-adv,n-t	summer
なつやすみ<br>夏休み<br>n	summer vacation,summer holiday
～など<br><br>n,n-suf,prt	et cetera
ななつ<br>七つ<br>n	seven
なん/なに<br>何<br>int,n	what
なのか<br>七日<br>n-adv	seven days,the seventh day (of the month)
なまえ<br>名前<br>n	name
ならう<br>習う<br>u-v	to learn
ならぶ<br>並ぶ<br>u-v,vi	to line up,to stand in a line
ならべる<br>並べる<br>ru-v,vt	to line up,to set up
なる<br><br>u-v	to become
なん～<br>何～<br>	what sort of ～
に<br>二<br>num	two
にぎやか<br><br>na-adj,n	bustling,busy
にく<br>肉<br>n	meat
にし<br>西<br>n	west
～にち<br>～日<br>	～ day of the month,for ～ days
にちようび<br>日曜日<br>n-adv,n	Sunday
にもつ<br>荷物<br>n	luggage
ニュース<br><br>n	news
にわ<br>庭<br>n	garden
～にん<br>～人<br>	counter for people
ぬぐ<br>脱ぐ<br>u-v	to take off clothes
ぬるい<br>温い<br>adj	lukewarm
ネクタイ<br><br>n	tie,necktie
ねこ<br>猫<br>n	cat
ねる<br>寝る<br>ru-v	to go to bed,to sleep
～ねん<br>～年<br>	～ years
ノート<br><br>n	notebook,exercise book
のぼる<br>登る<br>u-v	to climb
のみもの<br>飲み物<br>n	drink,beverage
のむ<br>飲む<br>u-v	to drink
のる<br>乗る<br>u-v	to get on,to ride in,to board
は<br>歯<br>n	tooth
パーティー<br><br>n	party
はい<br><br>conj,int	yes
～はい<br>～杯<br>n	counter for cupfuls
はいざら<br>灰皿<br>n	ashtray
はいる<br>入る<br>u-v	to enter,to contain,to hold
はがき<br>葉書<br>n	postcard
履くーはく<br><br>u-v	to wear,to put on (trousers)
はこ<br>箱<br>n	box
はし<br>橋<br>n	bridge
箸ーはし<br><br>n	chopsticks
はじまる<br>始まる<br>u-v,vi	to begin
はじめ<br>初め/始め<br>expr	beginning,start not saisho
はじめて<br>初めて<br>adv,n	for the first time
はしる<br>走る<br>u-v	to run
バス<br><br>n	bus
バター<br><br>n	butter
はたち<br>二十歳<br>n	20 years old,20th year
はたらく<br>働く<br>u-v	to work
はち<br>八<br>num	eight
はつか<br>二十日<br>n	twenty days,twentieth (day of the month)
はな<br>花<br>n	flower
はな<br>鼻<br>n	nose
はなし<br>話<br>n	talk,story
はなす<br>話す<br>u-v	to speak
はは<br>母<br>n	(one's own) mother
はやい<br>早い<br>adj	early
はやい<br>速い<br>adj	quick,fast
はる<br>春<br>n-adv,n-t	springtime
はる<br>貼る<br>u-v	to stick,to paste
はれ<br>晴れ<br>ru-v	clear weather
はれる<br>晴れる<br>ru-v	to be sunny
はん<br>半<br>n-adv,n,n-suf	half
ばん<br>晩<br>n-adv,n-t	evening not yoru
～ばん<br>～番<br>n-adv,n-t	～st/th best
パン<br><br>n	bread
ハンカチ<br><br>n	handkerchief
ばんごう<br>番号<br>n	(telephone) number
ばんごはん<br>晩御飯<br>n	dinner,evening meal
はんぶん<br>半分<br>	half
ひがし<br>東<br>n	east
～ひき<br>～匹<br>	counter for small animals
ひく<br>引く<br>u-v	to pull
ひく<br>弾く<br>u-v	to play (piano, guitar)
ひくい<br>低い<br>adj	short,low
ひこうき<br>飛行機<br>n	aeroplane,airplane
ひだり<br>左<br>n	left hand side
ひと<br>人<br>n	man,person
ひとつ<br>一つ<br>n	one
ひとつき<br>一月<br>	one month
ひとり<br>一人<br>n	one person
ひま<br>暇<br>na-adj,n	free time,leisure
ひゃく<br>百<br>num	100,hundred
びょういん<br>病院<br>n	hospital
びょうき<br>病気<br>n	illness,disease,sickness
ひらがな<br>平仮名<br>n	hiragana
ひる<br>昼<br>n-adv,n-t	noon,daytime
ひるごはん<br>昼御飯<br>n	lunch,midday meal
ひろい<br>広い<br>adj	spacious,wide
フィルム<br><br>n	film (roll of)
ふうとう<br>封筒<br>n	envelope
プール<br><br>n	swimming pool
フォーク<br /><br />n	fork
ふく<br>吹く<br>u-v	to blow (wind, etc)
ふく<br>服<br>n,n-suf	clothes
ふたつ<br>二つ<br>n	two
ぶたにく<br>豚肉<br>n	pork
ふたり<br>二人<br>n	two people
ふつか<br>二日<br>n	second day of the month,two days
ふとい<br>太い<br>adj	fat,thick
ふゆ<br>冬<br>n-adv,n-t	winter
ふる<br>降る<br>u-v	to precipitate,to fall (e.g. rain)
ふるい<br>古い<br>adj	old (not person),aged,ancient
風呂(ふろ)<br><br>n	bath
～ふん<br>～分<br>suf	～minutes
ぶんしょう<br>文章<br><br><br>	sentence,text
ページ<br><br>n	page
へた<br>下手<br>na-adj,n	unskillful,poor
ベッド<br><br>n	bed
ペット<br><br>n	pet
へや<br>部屋<br>n	room
へん<br>辺<br>n	area,vicinity not kinjo
ペン<br><br>n	pen
べんきょう（する）<br>勉強<br>n,vs	study,diligence
べんり<br>便利<br>na-adj,n	convenient,handy
ほう<br><br>	way
ぼうし<br>帽子<br>n	hat
ボールペン<br><br>n	ball-point pen
ほか<br>外<br>n	other place,the rest
ポケット<br><br>n	pocket
ほしい<br>欲しい<br>adj	want,in need of,desire
ポスト<br><br>n	post
ほそい<br>細い<br>adj	thin,slender,fine not komakai
ボタン<br><br>n	button
ホテル<br><br>n	hotel
ほん<br>本<br>n	book
～ほん<br>～本<br>	counter for long cylindrical things
ほんだな<br>本棚<br>n	bookshelves
ほんとう <br><br>adv	reality,truth not 実際
～まい<br>～枚<br>	counter for flat things
まいあさ<br>毎朝<br>n-adv,n-t	every morning
まいげつ/まいつき<br>毎月<br>n-adv,n	every month,monthly
まいしゅう<br>毎週<br>n-adv,n-t	every week
まいにち<br>毎日<br>n-adv,n-t	every day
まいねん/まいとし<br>毎年<br>n-t	every year,annually
まいばん<br>毎晩<br>n-adv,n-t	every night
まえ<br>前<br>n-adv,n-t,suf	before,in front
～まえ<br>～前<br>suf	in front of ～
まがる<br>曲る<br>u-v	to turn,to bend
まずい<br><br>adj	unappetising,unpleasant (taste)
また<br><br>adv,conj,n	again,and
まだ<br><br>adv	yet,still,besides (noch)
まち<br>町<br>n	town,city
まつ<br>待つ<br>u-v	to wait
まっすぐ<br><br>na-adj,adv,n	straight (ahead),direct
マッチ<br><br>n	match
まど<br>窓<br>n	window
まるい<br>丸い/円い<br>adj	round,circular
まん<br>万<br>adv,num	ten thousand,everything
まんねんひつ<br>万年筆<br>n	fountain pen
みがく<br>磨く<br>u-v	to brush (teeth)
みぎ<br>右<br>n	right hand side
みじかい<br>短い<br>adj	short not hikui
みず<br>水<br>n	water
みせ<br>店<br>n,n-suf	store,shop,establishment
みせる<br>見せる<br>ru-v	to show,to display not 示す
みち<br>道<br>n	road,street
みっか<br>三日<br>n	three days,the third day (of the month)
みっつ<br>三つ<br>n	three
みどり<br>緑<br>n	green
みなさん<br>皆さん<br>n	everyone
みなみ<br>南<br>n,vs	South,proceeding south
みみ<br>耳<br>n	ear
みる<br>見る<br>ru-v	to see,to watch
みんな<br><br>adv,n	all,everyone,everybody
むいか<br>六日<br>	six days,sixth (day of month)
むこう<br>向こう<br>n	beyond,over there, opposite side
むずかしい<br>難しい<br>adj	difficult
むっつ<br>六つ<br>num	six
むら<br>村<br>num	village
め<br>目<br>n	eye,eyeball
メートル<br><br>n	metre,meter
めがね<br>眼鏡<br>n	spectacles,glasses
もう<br><br>adv,int	already
もくようび<br>木曜日<br>n-adv,n	Thursday
もしもし<br><br>conj,int	hello (on phone)
もつ<br>持つ<br>u-v	(1) to hold,to carry,(2) to possess
もっと<br><br>adv	more,longer,farther
もの<br>物<br>n	thing,object
もん<br>門<br>n,n-suf	gate
もんだい<br>問題<br>n	problem,question
～や<br>屋<br>n	～ shop not mise
やおや<br>八百屋<br>n	greengrocer
やさい<br>野菜<br>n	vegetable
やさしい<br>易しい<br>adj	easy,plain,simple not kantan
やすい<br>安い<br>adj	cheap,inexpensive
やすみ<br>休み<br>n	rest,vacation,holiday
やすむ<br>休む<br>u-v,vi	to rest,to have a break,to take a day off kunyomi
やっつ<br>八つ<br>num	eight
やま<br>山<br>n	mountain
ゆうがた<br>夕方<br>n-adv,n-t	evening - not ban or ya or yoru
ゆうびんきょく<br>郵便局<br>n	post office
ゆうべ<br>昨夜<br>n	last night
ゆうめい<br>有名<br>na-adj,n	famous
ゆき<br>雪<br>n	snow
ゆっくり・と<br><br>adv,n	slowly,at ease
ようか<br>八日<br>n	eight days,the eighth (day of the month)
ようふく<br>洋服<br>n	Western-style clothes
よく<br><br>adv	frequently,often
よこ<br>横<br>n	beside,side,width
よっか<br>四日<br>n	(1) 4th day of month,(2) four days
よっつ<br>四つ<br>n	four
よぶ<br>呼ぶ<br>u-v	to call out,to invite
よむ<br>読む<br>u-v	to read
よる<br>夜<br>n	evening,night not ban
よわい<br>弱い<br>adj	weak,feable
らいげつ<br>来月<br>n-adv,n-t	next month
らいしゅう<br>来週<br>	next week
らいねん<br>来年<br>n-adv,n-t	next year
ラジオ<br><br>n	radio
ラジカセ<br><br>n	radio cassette player
立派ーりっぱ<br><br>na-adj,n	splendid,fine
りゅうがくせい<br>留学生<br>n	overseas student
りょうしん<br>両親<br>n	parents,both parents
りょうり<br>料理<br>n,vs	cooking,cuisine
りょこう<br>旅行<br>n,vs	travel,trip
れい<br>零<br>n	zero,nought
れいぞうこ<br>冷蔵庫<br>n	refrigerator
レコード<br><br>n	record
レストラン<br><br>n	restaurant
れんしゅう（する）<br>練習<br>n,vs	(to) practice
ろうか<br>廊下<br>n	corridor
ろく<br>六<br>num	six
ワイシャツ<br><br>n	shirt (lit: white shirt),business shirt
わかい<br>若い<br>adj	young
わかる<br>分かる<br>u-v	to understand
わすれる<br>忘れる<br>ru-v	to forget
わたし<br>私<br>adj-no,n	I,myself
わたくし<br>私<br>adj-no,n	I,myself
わたす<br>渡す<br>u-v	to pass over,to hand over
わたる<br>渡る<br>u-v	to cross over,to go across
わるい<br>悪い<br>adj	bad,inferior
激しいーはげしい	violent
体操	gymnastics	たいそう
全体的	on the whole	ぜんたいてき
語る	to speak/talk not hanasu	kataru
不安	anxiety unrest not shinpai	ふあん
疑問	doubt, question, guess not 推測	ぎもん
過去 かこ	past	
正直 ー しょうじき	upright	
祝日 ー しゅくじつ	holiday not 祭り or 休憩	
仲がいい	get on well	なかがいい
博物館	museum	はくぶつかん
進学	enter higher grade	しんがく
寿司ーすし	sushi	
就職試験 ー しゅうしょくしけん	job application exam	
袖 ーそで	sleeve	
散歩	stroll, walk	さんぽ
不幸 ふこう	misfortune	
手術ーしゅじゅつ	operation	
性格ーせいかく	character personality	
照明 ーしょうめい	lamp not 電灯	
結果 ー けっか	result	
流れるーながれる	to flow	
考慮ーこうりょ	consideration	
値するーあたい	to be worth	
世代ーせだい	generation	
超える 越える ー こえる	surpass,exceed,transcend	
直後ーちょくご	immediately after
念を押すーねんをおす	take care, ensure, emphasize	
希望ーきぼう	hope wish aspiration not 要望	
発売ーはつばい	product launch	
つまり	in other words	
事件ーじけん	affair, case	
犯人ーはんにん	culprit, criminal	
刑務所ーけいむしょ	prison	
爆破ーばくは	explosion	
内側ーうちがわ	inside, within	
外側ーそとがわ	outside	
大量ーたいりょう	large quantity	
煙ーけむり	smoke	
経つーたつ	to pass, elapse	
感動するーかんどう	to be deeply moved	
叫ぶーさけぶ	shout	
内容ーないよう	details	
墓地ーぼち	cemetery
現金ーげんきん	cash, ready money
政府ーせいふ	government
秘密ーひみつ	secret
保険ーほけん	insurance
殺人事件ーさつじんじけん	murder case
全くーまったく	completely and utterly
近づくーちかづく	to draw near
逮捕ーたいほ	arrest jukugo (maybe after a dragnet)
手に入れる	obtain, get hold of
交換ーこうかん	exchange (noun jukugo)
冗談ーじょうだん	joke
偶然ーぐうぜん	by accident
手帳ーてちょう	notebook
泥ーどろ	mud
天井ーてんじょ	ceiling
権利ーけんり	right, privilege
居間ーいま	living room
表情ーひょうじょう	expression, countenance
決意ーけつい	determination
不思議ーふしぎ	marvel, mystery, wonder
体調不良ーたいちょうふりょう	poor physical health
獣医ーじゅうい	vet
思い浮かべるーおもいうかべる	to be reminded of
眺めるーながめる	gaze, stare
輝くーかがやく	to glitter
のんびり	carefree, at leisure not 暇
癒すーいやす	heal, cure, soothe
水遣りーみずやり	watering of plants
離れるーはなれる	to be separated, detached not 分かれる
想像ーそうぞう	imagination
枯れるーかれる	wither, mature
気づくーきづく	to notice
絶望ーぜつぼう	despair
乗り越えるーのりこえる	overcome
穏やかーおだやか	calm, gentle, quiet
緩やかーゆるやか	slack, gentle, lenient
腰ーこし	back, hips, waist
拳銃ーけんじゅう	pistol, revolver
収まるーおさまる	to be installed
ぼんやり	faintly
凸凹ーでこぼこ	uneven
速度ーそくど	speed
限るーかぎる	restrict, limit
同時ーどうじ	simultaneous, concurrent
満足ーまんぞく	satisfaction
看板ーかんばん	signboard
街灯ーがいとう	streetlight
猛烈ーもうれつ	violent, like crazy
燃料ーねんりょう	fuel
去るーさる	to go away, leave, sich verpieseln
外れーはずれ	outskirts not 郊外
面積ーめんせき	(surface) area
作動ーさどう	operation, function
居住ーきょじゅう	residence not 住所
宗教的ーしゅうきょうてき	religious, spiritual
整備ーせいび	servicing
新品同様ーしんぴんどうよう	as good as new
弾ーたま	ball, bullet
姿ーすがた	figure, form
要望ーようぼう	demand, request n.
早朝ーそうちょう	early morning
興奮ーこうふん	excitement, arrousal
毒ーどく	poison, spite, abusive language
からかう	tease, ridicule not 苛める
修復ーしゅうふく	repair, return to service jukugo
互いにーたがいに	one another
痛みーいたみ	pain, distress
頭脳ーずのう	brains, intellect
理解ーりかい	understanding, sympathy
確認ーかくにん	confirmation
状態ーじょうたい	condition, situation, circumstances, state not 様子 or 都合 or 具合
恐ろしいーおそろしい	terrible, suprising
疑うーうたがう	to doubt kunyomi
現れるーあらわれる	to appear
我慢ーがまん	patience
曖昧ーあいまい	vague
憤慨ーふんがい	indignation, resentment
印象ーいんしょう	impression
国籍ーこくせき	nationality
種類ーしゅるい	kind, sort, variety, species
文句-もんく	complaint
撃ち殺すーうちころす	to shoot to death
他人ーたにん	another person
滞在ーたいざい	stay (a while somewhere) jukugo
隠すーかくす	to hide, conceal
責任ーせきにん	duty, responsibility
隙間ーすきま	crack, crevice
漏れるーもれる	to leak, escape, shine through
毛布ーもうふ	blanket
ぼやく	to grumble not 呟く
御愁傷様ーごしゅうしょうさま	my condolences
握るーにぎる	to clasp, grasp
現すーあらわす	to reveal
霧ーきり	fog, mist
完全ーかんぜん	perfection, completeness
眩しいーまぶしい	dazzling not 輝く
皮肉ーひにく	sarcasm
果てしないーはてしない	endless
埃ーほこり	dust
素直ーすなお	frank, honest not 正直
振り向くーふりむく	to turn around, look over one's shoulder
失うーうしなう	to lose, part with not 無くす
迫るーせまる	to urge, to approach
微笑ーびしょう	smile
微笑むーほほえむ	to smile
呟くーつぶやく	mutter
覚ますーさます	awaken, sober up
振るーふる	to shake, swing not 揺れる
一瞬ーいっしゅん	a moment, instant
歓迎ーかんげい	welcome, reception
勧めるーすすめる	recommend, advise, offer
革命ーかくめい	revolution
達するーたっする	to reach, attain
貧しいーまずしい	poor, needy not 貧乏
投票ーとうひょう	voting
選挙ーせんきょ	election
気違いーきちがい	madness
鐘ーかね	bell (kanji)
求めるーもとめる	to request, demand
愚かーおろか	foolish
視線ーしせん	glance, line of sight
方角ーほうがく	direction jukugo
延々延びるーえんえんのびる	to stretch endlessly
地平線ーちへいせん	horizon
口調ーくちょう	tone of voice
唸るーうなる	groan moan howl growl
可哀想ーかわいそう	poor, miserable, pathetic
繰り返すーくりかえす	to repeat
迷うーまよう	to lose one's way
指し示すーさししめす	to point to
聴解ーちょうかい	listening comprehension
避けるーさける	to avoid
世紀ーせいき	century
命令ーめいれい	order, command, imperative not 要望	
脇ーわき	armpit, flank, beside
砂利道ーじゃりみち	gravel path
案外ーあんがい	unexpected
実際ーじっさい	reality, practicality
首相ーしゅしょう	prime minister
悟ーさとる	realise
明らかーあきらか	clear, obvious not はっきり
有効性ーゆうこうせい	effectiveness	
避難所ーひなんじょ	place of refuge
変更ーへんこう	change n.( of plan)
快諾ーかいだく	ready, cheerful consent
誤りーあやまり	mistake, not 間違え
役割を果たすーやくわりをはたす	to play a role
推測ーすいそく	guess
俳優ーはいゆう	actor
拳ーこぶし	fist